"GeographyCode","KS604EW0001","KS604EW0002","KS604EW0003","KS604EW0004","KS604EW0005","KS604EW0006","KS604EW0007","KS604EW0008","KS604EW0009","KS604EW0010","KS604EW0011","KS604EW0012","KS604EW0013","KS604EW0014","KS604EW0015","KS604EW0016","KS604EW0017","KS604EW0018","KS604EW0019","KS604EW0020","KS604EW0021","KS604EW0022","KS604EW0023","KS604EW0024","KS604EW0025","KS604EW0026","KS604EW0027","KS604EW0028","KS604EW0029"
"E01000842",849,64,90,401,294,450,26,32,197,195,399,38,58,204,99,7.53828032979976,10.6007067137809,47.2320376914017,34.6289752650177,53.0035335689046,3.06242638398115,3.76914016489988,23.2037691401649,22.9681978798587,46.9964664310954,4.47585394581861,6.83156654888104,24.0282685512367,11.660777385159
"E01000843",909,71,96,446,296,455,18,38,217,182,454,53,58,229,114,7.81078107810781,10.5610561056106,49.0649064906491,32.5632563256326,50.0550055005501,1.98019801980198,4.18041804180418,23.8723872387239,20.02200220022,49.9449944994499,5.83058305830583,6.38063806380638,25.1925192519252,12.5412541254125
"E01000844",1089,58,96,546,389,594,16,38,293,247,495,42,58,253,142,5.32598714416896,8.81542699724518,50.1377410468319,35.7208448117539,54.5454545454545,1.4692378328742,3.48943985307622,26.9054178145087,22.6813590449954,45.4545454545455,3.85674931129477,5.32598714416896,23.2323232323232,13.0394857667585
"E01000845",847,61,87,441,258,432,19,22,218,173,415,42,65,223,85,7.20188902007084,10.271546635183,52.0661157024793,30.4604486422668,51.0035419126328,2.24321133412042,2.5974025974026,25.7378984651712,20.4250295159386,48.9964580873672,4.95867768595041,7.6741440377804,26.3282172373081,10.0354191263282
"E01000846",582,62,127,289,104,308,20,49,163,76,274,42,78,126,28,10.6529209621993,21.8213058419244,49.6563573883162,17.8694158075601,52.9209621993127,3.43642611683849,8.4192439862543,28.0068728522337,13.0584192439863,47.0790378006873,7.21649484536082,13.4020618556701,21.6494845360825,4.81099656357388
"E01000847",712,59,112,347,194,404,20,44,185,155,308,39,68,162,39,8.28651685393258,15.7303370786517,48.7359550561798,27.247191011236,56.7415730337079,2.80898876404494,6.17977528089888,25.9831460674157,21.7696629213483,43.2584269662921,5.47752808988764,9.55056179775281,22.752808988764,5.47752808988764
"E01000848",1008,62,108,502,336,521,21,29,244,227,487,41,79,258,109,6.15079365079365,10.7142857142857,49.8015873015873,33.3333333333333,51.6865079365079,2.08333333333333,2.87698412698413,24.2063492063492,22.5198412698413,48.3134920634921,4.06746031746032,7.83730158730159,25.5952380952381,10.8134920634921
"E01000849",982,58,128,511,285,487,20,39,249,179,495,38,89,262,106,5.90631364562118,13.0346232179226,52.0366598778004,29.0224032586558,49.5926680244399,2.03665987780041,3.97148676171079,25.3564154786151,18.2281059063136,50.4073319755601,3.86965376782077,9.06313645621181,26.6802443991853,10.7942973523422
"E01000850",937,66,93,543,235,559,29,41,328,161,378,37,52,215,74,7.04375667022412,9.92529348986126,57.9509071504803,25.0800426894344,59.65848452508,3.09498399146211,4.37566702241195,35.0053361792956,17.1824973319104,40.34151547492,3.94877267876201,5.54962646744931,22.9455709711846,7.89754535752401
"E01000851",1017,147,113,526,231,625,86,51,327,161,392,61,62,199,70,14.4542772861357,11.1111111111111,51.7207472959685,22.7138643067847,61.4552605703048,8.45624385447394,5.01474926253687,32.1533923303835,15.8308751229105,38.5447394296952,5.99803343166175,6.09636184857424,19.5673549655851,6.88298918387414
"E01000852",497,127,58,218,94,277,58,23,136,60,220,69,35,82,34,25.5533199195171,11.6700201207243,43.8631790744467,18.9134808853119,55.7344064386318,11.6700201207243,4.62776659959759,27.364185110664,12.0724346076459,44.2655935613682,13.8832997987928,7.04225352112676,16.4989939637827,6.841046277666
"E01000853",622,66,119,349,88,306,33,48,166,59,316,33,71,183,29,10.6109324758842,19.1318327974277,56.1093247588424,14.1479099678457,49.1961414790997,5.30546623794212,7.71704180064309,26.6881028938907,9.48553054662379,50.8038585209003,5.30546623794212,11.4147909967846,29.4212218649518,4.66237942122186
"E01000854",638,77,104,307,150,356,41,39,179,97,282,36,65,128,53,12.0689655172414,16.3009404388715,48.1191222570533,23.5109717868339,55.7993730407524,6.42633228840125,6.1128526645768,28.0564263322884,15.2037617554859,44.2006269592476,5.64263322884013,10.1880877742947,20.0626959247649,8.30721003134796
"E01000855",1110,53,118,696,243,600,30,65,352,153,510,23,53,344,90,4.77477477477477,10.6306306306306,62.7027027027027,21.8918918918919,54.0540540540541,2.7027027027027,5.85585585585586,31.7117117117117,13.7837837837838,45.945945945946,2.07207207207207,4.77477477477477,30.990990990991,8.10810810810811
"E01000856",731,77,130,417,107,395,36,53,225,81,336,41,77,192,26,10.5335157318741,17.7838577291382,57.0451436388509,14.6374829001368,54.0355677154583,4.92476060191518,7.25034199726402,30.7797537619699,11.0807113543092,45.9644322845417,5.60875512995896,10.5335157318741,26.265389876881,3.55677154582763
"E01000857",773,43,98,390,242,412,15,32,205,160,361,28,66,185,82,5.5627425614489,12.6778783958603,50.4527813712807,31.3065976714101,53.2988357050453,1.9404915912031,4.13971539456662,26.5200517464424,20.6985769728331,46.7011642949547,3.6222509702458,8.53816300129366,23.9327296248383,10.608020698577
"E01000858",801,67,138,421,175,429,21,60,235,113,372,46,78,186,62,8.3645443196005,17.2284644194757,52.5593008739076,21.8476903870162,53.5580524344569,2.62172284644195,7.49063670411985,29.3383270911361,14.1073657927591,46.4419475655431,5.74282147315855,9.73782771535581,23.2209737827715,7.74032459425718
"E01000859",992,72,122,450,348,522,19,53,229,221,470,53,69,221,127,7.25806451612903,12.2983870967742,45.3629032258064,35.0806451612903,52.6209677419355,1.91532258064516,5.34274193548387,23.0846774193548,22.2782258064516,47.3790322580645,5.34274193548387,6.95564516129032,22.2782258064516,12.8024193548387
"E01000860",656,58,85,346,167,316,20,33,156,107,340,38,52,190,60,8.84146341463415,12.9573170731707,52.7439024390244,25.4573170731707,48.1707317073171,3.04878048780488,5.03048780487805,23.780487804878,16.3109756097561,51.8292682926829,5.79268292682927,7.92682926829268,28.9634146341463,9.14634146341463
"E01000861",839,88,122,482,147,455,34,59,260,102,384,54,63,222,45,10.4886769964243,14.5411203814064,57.4493444576877,17.5208581644815,54.2312276519666,4.05244338498212,7.03218116805721,30.9892729439809,12.1573301549464,45.7687723480334,6.43623361144219,7.50893921334923,26.4600715137068,5.36352800953516
"E01000862",1020,64,120,514,322,560,27,41,261,231,460,37,79,253,91,6.27450980392157,11.7647058823529,50.3921568627451,31.5686274509804,54.9019607843137,2.64705882352941,4.01960784313725,25.5882352941176,22.6470588235294,45.0980392156863,3.62745098039216,7.74509803921569,24.8039215686275,8.92156862745098
"E01000863",907,86,101,513,207,485,37,42,260,146,422,49,59,253,61,9.48180815876516,11.135611907387,56.5600882028666,22.8224917309813,53.4729878721058,4.07938257993385,4.63065049614112,28.6659316427784,16.0970231532525,46.5270121278942,5.40242557883131,6.50496141124587,27.8941565600882,6.72546857772878
"E01000864",876,56,132,516,172,449,16,51,265,117,427,40,81,251,55,6.39269406392694,15.0684931506849,58.9041095890411,19.634703196347,51.2557077625571,1.82648401826484,5.82191780821918,30.2511415525114,13.3561643835616,48.7442922374429,4.5662100456621,9.24657534246575,28.6529680365297,6.27853881278539
"E01000865",642,107,100,309,126,333,41,48,164,80,309,66,52,145,46,16.6666666666667,15.5763239875389,48.1308411214953,19.6261682242991,51.8691588785047,6.38629283489097,7.47663551401869,25.5451713395639,12.4610591900312,48.1308411214953,10.2803738317757,8.09968847352025,22.5856697819315,7.16510903426791
"E01000866",1044,83,169,591,201,511,21,66,310,114,533,62,103,281,87,7.95019157088123,16.1877394636015,56.6091954022989,19.2528735632184,48.9463601532567,2.01149425287356,6.32183908045977,29.6934865900383,10.9195402298851,51.0536398467433,5.93869731800766,9.86590038314176,26.9157088122605,8.33333333333333
"E01000867",700,57,134,403,106,380,24,61,227,68,320,33,73,176,38,8.14285714285714,19.1428571428571,57.5714285714286,15.1428571428571,54.2857142857143,3.42857142857143,8.71428571428572,32.4285714285714,9.71428571428571,45.7142857142857,4.71428571428571,10.4285714285714,25.1428571428571,5.42857142857143
"E01000868",605,72,130,332,71,312,27,61,182,42,293,45,69,150,29,11.900826446281,21.4876033057851,54.8760330578512,11.7355371900826,51.5702479338843,4.46280991735537,10.0826446280992,30.0826446280992,6.94214876033058,48.4297520661157,7.43801652892562,11.404958677686,24.7933884297521,4.79338842975207
"E01000869",1166,101,165,660,240,617,39,67,360,151,549,62,98,300,89,8.66209262435678,14.1509433962264,56.6037735849057,20.5831903945111,52.9159519725557,3.34476843910806,5.74614065180103,30.8747855917667,12.9502572898799,47.0840480274443,5.31732418524871,8.40480274442539,25.7289879931389,7.63293310463122
"E01000870",873,66,142,506,159,419,18,44,255,102,454,48,98,251,57,7.56013745704467,16.2657502863688,57.9610538373425,18.213058419244,47.9954180985109,2.06185567010309,5.04009163802978,29.2096219931272,11.6838487972509,52.0045819014891,5.49828178694158,11.2256586483391,28.7514318442153,6.52920962199313
"E01000871",865,79,123,462,201,457,25,40,247,145,408,54,83,215,56,9.13294797687861,14.2196531791908,53.4104046242775,23.2369942196532,52.8323699421965,2.89017341040462,4.6242774566474,28.5549132947977,16.7630057803468,47.1676300578035,6.24277456647399,9.59537572254335,24.8554913294798,6.47398843930636
"E01000872",1191,77,141,772,201,637,20,59,414,144,554,57,82,358,57,6.46515533165407,11.8387909319899,64.8194794290512,16.8765743073048,53.4844668345928,1.67926112510495,4.95382031905961,34.7607052896725,12.0906801007557,46.5155331654072,4.78589420654912,6.88497061293031,30.0587741393787,4.78589420654912
"E01000873",1004,69,113,581,241,527,36,42,296,153,477,33,71,285,88,6.87250996015936,11.2549800796813,57.8685258964143,24.003984063745,52.4900398406375,3.58565737051793,4.18326693227092,29.4820717131474,15.2390438247012,47.5099601593625,3.28685258964143,7.07171314741036,28.3864541832669,8.76494023904383
"E01000874",943,82,109,502,250,482,28,41,251,162,461,54,68,251,88,8.69565217391304,11.558854718982,53.2343584305408,26.5111346765642,51.1134676564157,2.96924708377519,4.34782608695652,26.6171792152704,17.1792152704136,48.8865323435843,5.72640509013786,7.21102863202545,26.6171792152704,9.33191940615058
"E01000875",982,55,119,610,198,525,21,60,325,119,457,34,59,285,79,5.60081466395112,12.1181262729124,62.1181262729124,20.162932790224,53.4623217922607,2.13849287169043,6.10997963340122,33.0957230142566,12.1181262729124,46.5376782077393,3.46232179226069,6.0081466395112,29.0224032586558,8.04480651731161
"E01000876",839,74,106,502,157,433,27,49,264,93,406,47,57,238,64,8.82002383790226,12.6340882002384,59.8331346841478,18.7127532777116,51.6090584028606,3.2181168057211,5.84028605482718,31.4660309892729,11.0846245530393,48.3909415971395,5.60190703218117,6.7938021454112,28.3671036948748,7.62812872467223
"E01000877",973,49,105,588,231,505,20,36,290,159,468,29,69,298,72,5.03597122302158,10.7913669064748,60.431654676259,23.7410071942446,51.9013360739979,2.05549845837616,3.69989722507708,29.8047276464543,16.3412127440904,48.0986639260021,2.98047276464543,7.09146968139774,30.6269270298047,7.39979445015416
"E01000878",675,103,84,292,196,385,41,34,171,139,290,62,50,121,57,15.2592592592593,12.4444444444444,43.2592592592593,29.037037037037,57.037037037037,6.07407407407407,5.03703703703704,25.3333333333333,20.5925925925926,42.962962962963,9.18518518518519,7.40740740740741,17.9259259259259,8.44444444444444
"E01000879",737,74,91,340,232,408,26,34,180,168,329,48,57,160,64,10.0407055630936,12.3473541383989,46.1329715061058,31.4789687924016,55.359565807327,3.52781546811398,4.61329715061058,24.4233378561737,22.7951153324288,44.640434192673,6.51289009497965,7.73405698778833,21.7096336499322,8.68385345997286
"E01000880",790,57,81,356,296,444,18,28,179,219,346,39,53,177,77,7.21518987341772,10.253164556962,45.0632911392405,37.4683544303797,56.2025316455696,2.27848101265823,3.54430379746835,22.6582278481013,27.7215189873418,43.7974683544304,4.93670886075949,6.70886075949367,22.4050632911392,9.74683544303798
"E01000881",795,55,95,384,261,424,16,40,193,175,371,39,55,191,86,6.91823899371069,11.9496855345912,48.3018867924528,32.8301886792453,53.3333333333333,2.0125786163522,5.0314465408805,24.2767295597484,22.0125786163522,46.6666666666667,4.90566037735849,6.91823899371069,24.0251572327044,10.8176100628931
"E01000882",954,69,92,464,329,506,24,32,231,219,448,45,60,233,110,7.23270440251572,9.64360587002096,48.6373165618449,34.4863731656185,53.0398322851153,2.51572327044025,3.35429769392034,24.2138364779874,22.9559748427673,46.9601677148847,4.71698113207547,6.28930817610063,24.4234800838574,11.5303983228512
"E01000883",717,48,57,383,229,384,16,23,203,142,333,32,34,180,87,6.69456066945607,7.94979079497908,53.4170153417015,31.9386331938633,53.5564853556485,2.23152022315202,3.20781032078103,28.3124128312413,19.8047419804742,46.4435146443515,4.46304044630404,4.74198047419805,25.1046025104602,12.1338912133891
"E01000884",716,89,108,277,242,396,34,31,149,182,320,55,77,128,60,12.4301675977654,15.0837988826816,38.6871508379888,33.7988826815642,55.3072625698324,4.74860335195531,4.32960893854749,20.8100558659218,25.4189944134078,44.6927374301676,7.68156424581006,10.7541899441341,17.877094972067,8.37988826815642
"E01000885",664,78,100,274,212,382,29,39,161,153,282,49,61,113,59,11.7469879518072,15.0602409638554,41.2650602409639,31.9277108433735,57.5301204819277,4.36746987951807,5.87349397590361,24.2469879518072,23.0421686746988,42.4698795180723,7.37951807228916,9.18674698795181,17.0180722891566,8.8855421686747
"E01000886",802,54,138,437,173,404,15,52,217,120,398,39,86,220,53,6.73316708229426,17.2069825436409,54.4887780548628,21.571072319202,50.3740648379052,1.87032418952618,6.48379052369077,27.0573566084788,14.9625935162095,49.6259351620948,4.86284289276808,10.7231920199501,27.431421446384,6.60847880299252
"E01000887",885,55,105,493,232,450,23,23,252,152,435,32,82,241,80,6.21468926553672,11.864406779661,55.7062146892655,26.2146892655367,50.8474576271186,2.59887005649718,2.59887005649718,28.4745762711864,17.1751412429379,49.1525423728814,3.61581920903955,9.26553672316384,27.2316384180791,9.03954802259887
"E01000888",812,67,123,424,198,421,22,36,228,135,391,45,87,196,63,8.2512315270936,15.1477832512315,52.2167487684729,24.384236453202,51.8472906403941,2.70935960591133,4.43349753694581,28.0788177339901,16.6256157635468,48.1527093596059,5.54187192118227,10.7142857142857,24.1379310344828,7.75862068965517
"E01000889",659,71,137,368,83,329,31,49,195,54,330,40,88,173,29,10.7738998482549,20.7890743550835,55.8421851289833,12.5948406676783,49.9241274658574,4.7040971168437,7.43550834597876,29.5902883156297,8.19423368740516,50.0758725341426,6.06980273141123,13.3535660091047,26.2518968133536,4.40060698027314
"E01000890",575,68,147,314,46,304,27,70,170,37,271,41,77,144,9,11.8260869565217,25.5652173913043,54.6086956521739,8,52.8695652173913,4.69565217391304,12.1739130434783,29.5652173913043,6.43478260869565,47.1304347826087,7.1304347826087,13.3913043478261,25.0434782608696,1.56521739130435
"E01000891",540,56,120,303,61,290,20,65,163,42,250,36,55,140,19,10.3703703703704,22.2222222222222,56.1111111111111,11.2962962962963,53.7037037037037,3.7037037037037,12.037037037037,30.1851851851852,7.77777777777778,46.2962962962963,6.66666666666667,10.1851851851852,25.9259259259259,3.51851851851852
"E01000892",943,45,133,521,244,498,12,46,274,166,445,33,87,247,78,4.77200424178155,14.1039236479321,55.2492046659597,25.8748674443266,52.8101802757158,1.27253446447508,4.8780487804878,29.0562036055143,17.6033934252386,47.1898197242842,3.49946977730647,9.22587486744433,26.1930010604454,8.27147401908802
"E01000893",900,94,137,410,259,449,21,57,197,174,451,73,80,213,85,10.4444444444444,15.2222222222222,45.5555555555556,28.7777777777778,49.8888888888889,2.33333333333333,6.33333333333333,21.8888888888889,19.3333333333333,50.1111111111111,8.11111111111111,8.88888888888889,23.6666666666667,9.44444444444444
"E01000894",767,65,106,325,271,426,17,43,166,200,341,48,63,159,71,8.47457627118644,13.8200782268579,42.3728813559322,35.3324641460235,55.5410691003911,2.21642764015645,5.60625814863103,21.6427640156454,26.0756192959583,44.4589308996089,6.25814863102999,8.21382007822686,20.7301173402868,9.25684485006519
"E01000895",893,75,99,426,293,501,17,45,223,216,392,58,54,203,77,8.3986562150056,11.0862262038074,47.7043673012318,32.8107502799552,56.1030235162374,1.9036954087346,5.03919372900336,24.9720044792833,24.1881298992161,43.8969764837626,6.494960806271,6.04703247480403,22.7323628219485,8.62262038073908
"E01000896",910,59,124,415,312,514,19,61,208,226,396,40,63,207,86,6.48351648351648,13.6263736263736,45.6043956043956,34.2857142857143,56.4835164835165,2.08791208791209,6.7032967032967,22.8571428571429,24.8351648351648,43.5164835164835,4.3956043956044,6.92307692307692,22.7472527472527,9.45054945054945
"E01000897",870,74,95,355,346,484,17,37,184,246,386,57,58,171,100,8.50574712643678,10.9195402298851,40.8045977011494,39.7701149425287,55.632183908046,1.95402298850575,4.25287356321839,21.1494252873563,28.2758620689655,44.367816091954,6.55172413793103,6.66666666666667,19.6551724137931,11.4942528735632
"E01000898",978,60,79,571,268,510,22,44,276,168,468,38,35,295,100,6.13496932515337,8.07770961145194,58.3844580777096,27.4028629856851,52.1472392638037,2.24948875255624,4.49897750511247,28.2208588957055,17.1779141104294,47.8527607361963,3.88548057259714,3.57873210633947,30.1635991820041,10.2249488752556
"E01000899",826,87,91,352,296,467,24,28,201,214,359,63,63,151,82,10.5326876513317,11.0169491525424,42.6150121065375,35.8353510895884,56.5375302663438,2.90556900726392,3.38983050847458,24.3341404358354,25.90799031477,43.4624697336562,7.6271186440678,7.6271186440678,18.2808716707022,9.9273607748184
"E01000900",885,70,122,518,175,446,29,55,254,108,439,41,67,264,67,7.90960451977401,13.7853107344633,58.5310734463277,19.774011299435,50.3954802259887,3.27683615819209,6.21468926553672,28.7005649717514,12.2033898305085,49.6045197740113,4.63276836158192,7.57062146892655,29.8305084745763,7.57062146892655
"E01000901",680,63,149,377,91,341,27,62,196,56,339,36,87,181,35,9.26470588235294,21.9117647058824,55.4411764705882,13.3823529411765,50.1470588235294,3.97058823529412,9.11764705882353,28.8235294117647,8.23529411764706,49.8529411764706,5.29411764705882,12.7941176470588,26.6176470588235,5.14705882352941
"E01000902",550,61,111,301,77,276,32,46,143,55,274,29,65,158,22,11.0909090909091,20.1818181818182,54.7272727272727,14,50.1818181818182,5.81818181818182,8.36363636363636,26,10,49.8181818181818,5.27272727272727,11.8181818181818,28.7272727272727,4
"E01000903",768,67,97,403,201,400,24,40,201,135,368,43,57,202,66,8.72395833333333,12.6302083333333,52.4739583333333,26.171875,52.0833333333333,3.125,5.20833333333333,26.171875,17.578125,47.9166666666667,5.59895833333333,7.421875,26.3020833333333,8.59375
"E01000904",1016,83,181,561,191,515,31,78,273,133,501,52,103,288,58,8.16929133858268,17.8149606299213,55.2165354330709,18.7992125984252,50.6889763779528,3.0511811023622,7.67716535433071,26.8700787401575,13.0905511811024,49.3110236220472,5.11811023622047,10.1377952755906,28.3464566929134,5.70866141732284
"E01000905",693,78,155,381,79,340,25,70,199,46,353,53,85,182,33,11.2554112554113,22.3665223665224,54.978354978355,11.3997113997114,49.0620490620491,3.60750360750361,10.1010101010101,28.7157287157287,6.63780663780664,50.9379509379509,7.64790764790765,12.2655122655123,26.2626262626263,4.76190476190476
"E01000906",945,59,86,508,292,454,20,30,215,189,491,39,56,293,103,6.24338624338624,9.1005291005291,53.7566137566138,30.8994708994709,48.042328042328,2.11640211640212,3.17460317460317,22.7513227513227,20,51.957671957672,4.12698412698413,5.92592592592593,31.005291005291,10.8994708994709
"E01000907",639,51,122,356,110,312,14,44,178,76,327,37,78,178,34,7.981220657277,19.0923317683881,55.7120500782473,17.2143974960876,48.8262910798122,2.19092331768388,6.88575899843505,27.8560250391236,11.8935837245696,51.1737089201878,5.79029733959311,12.2065727699531,27.8560250391236,5.320813771518
"E01000908",758,88,153,397,120,336,31,36,194,75,422,57,117,203,45,11.6094986807388,20.1846965699208,52.3746701846966,15.8311345646438,44.3271767810026,4.08970976253298,4.74934036939314,25.5936675461741,9.89445910290237,55.6728232189974,7.5197889182058,15.4353562005277,26.7810026385224,5.93667546174142
"E01000909",836,92,129,444,171,423,29,39,234,121,413,63,90,210,50,11.0047846889952,15.4306220095694,53.11004784689,20.4545454545455,50.5980861244019,3.4688995215311,4.66507177033493,27.9904306220096,14.4736842105263,49.4019138755981,7.53588516746411,10.7655502392345,25.1196172248804,5.98086124401914
"E01000910",810,71,120,449,170,406,22,37,231,116,404,49,83,218,54,8.76543209876543,14.8148148148148,55.4320987654321,20.9876543209877,50.1234567901235,2.71604938271605,4.5679012345679,28.5185185185185,14.320987654321,49.8765432098765,6.04938271604938,10.2469135802469,26.9135802469136,6.66666666666667
"E01000911",755,53,141,420,141,373,16,50,214,93,382,37,91,206,48,7.01986754966887,18.6754966887417,55.6291390728477,18.6754966887417,49.4039735099338,2.11920529801325,6.62251655629139,28.3443708609272,12.317880794702,50.5960264900662,4.90066225165563,12.0529801324503,27.2847682119205,6.35761589403973
"E01000912",757,67,124,461,105,352,17,41,223,71,405,50,83,238,34,8.85072655217966,16.3804491413474,60.8982826948481,13.8705416116248,46.4993394980185,2.24570673712021,5.41611624834874,29.4583883751651,9.37912813738441,53.5006605019815,6.60501981505945,10.9643328929987,31.439894319683,4.49141347424042
"E01000913",938,104,136,446,252,510,32,50,244,184,428,72,86,202,68,11.0874200426439,14.498933901919,47.5479744136461,26.865671641791,54.3710021321962,3.41151385927505,5.33049040511727,26.0127931769723,19.6162046908316,45.6289978678038,7.67590618336887,9.16844349680171,21.5351812366738,7.24946695095949
"E01000914",952,75,86,493,298,556,27,41,287,201,396,48,45,206,97,7.8781512605042,9.03361344537815,51.7857142857143,31.3025210084034,58.4033613445378,2.83613445378151,4.30672268907563,30.1470588235294,21.1134453781513,41.5966386554622,5.04201680672269,4.72689075630252,21.6386554621849,10.1890756302521
"E01000915",675,52,109,374,140,393,20,55,224,94,282,32,54,150,46,7.7037037037037,16.1481481481481,55.4074074074074,20.7407407407407,58.2222222222222,2.96296296296296,8.14814814814815,33.1851851851852,13.9259259259259,41.7777777777778,4.74074074074074,8,22.2222222222222,6.81481481481481
"E01000916",972,55,109,496,312,575,22,54,278,221,397,33,55,218,91,5.65843621399177,11.2139917695473,51.0288065843621,32.0987654320988,59.156378600823,2.26337448559671,5.55555555555556,28.6008230452675,22.7366255144033,40.843621399177,3.39506172839506,5.65843621399177,22.4279835390947,9.36213991769547
"E01000917",726,75,154,386,111,423,41,80,228,74,303,34,74,158,37,10.3305785123967,21.2121212121212,53.168044077135,15.2892561983471,58.2644628099173,5.64738292011019,11.0192837465565,31.404958677686,10.1928374655647,41.7355371900826,4.6831955922865,10.1928374655647,21.763085399449,5.09641873278237
"E01000918",1038,131,168,515,224,617,62,95,295,165,421,69,73,220,59,12.6204238921002,16.1849710982659,49.6146435452794,21.5799614643545,59.4412331406551,5.97302504816956,9.15221579961464,28.4200385356455,15.8959537572254,40.5587668593449,6.64739884393064,7.03275529865125,21.1946050096339,5.68400770712909
"E01000919",1008,124,154,494,236,610,40,106,289,175,398,84,48,205,61,12.3015873015873,15.2777777777778,49.0079365079365,23.4126984126984,60.515873015873,3.96825396825397,10.515873015873,28.6706349206349,17.3611111111111,39.484126984127,8.33333333333333,4.76190476190476,20.3373015873016,6.0515873015873
"E01000920",1094,77,143,566,308,636,29,73,336,198,458,48,70,230,110,7.03839122486289,13.0712979890311,51.7367458866545,28.1535648994516,58.1352833638026,2.6508226691042,6.672760511883,30.7129798903108,18.0987202925046,41.8647166361974,4.38756855575868,6.39853747714808,21.0237659963437,10.054844606947
"E01000921",1257,70,168,801,218,632,28,71,408,125,625,42,97,393,93,5.56881463802705,13.3651551312649,63.7231503579952,17.3428798727128,50.2784407319014,2.22752585521082,5.64836913285601,32.4582338902148,9.94431185361973,49.7215592680986,3.34128878281623,7.71678599840891,31.2649164677804,7.39856801909308
"E01000922",756,69,91,461,135,406,27,35,256,88,350,42,56,205,47,9.12698412698413,12.037037037037,60.978835978836,17.8571428571429,53.7037037037037,3.57142857142857,4.62962962962963,33.8624338624339,11.6402116402116,46.2962962962963,5.55555555555556,7.40740740740741,27.1164021164021,6.21693121693122
"E01000923",795,67,113,434,181,390,23,38,216,113,405,44,75,218,68,8.42767295597484,14.2138364779874,54.5911949685535,22.7672955974843,49.0566037735849,2.89308176100629,4.77987421383648,27.1698113207547,14.2138364779874,50.9433962264151,5.53459119496855,9.43396226415094,27.4213836477987,8.55345911949686
"E01000924",989,78,134,564,213,509,31,42,309,127,480,47,92,255,86,7.88675429726997,13.5490394337715,57.0273003033367,21.5369059656218,51.4661274014156,3.13447927199191,4.24671385237614,31.2436804853387,12.8412537917088,48.5338725985844,4.75227502527806,9.30232558139535,25.783619817998,8.69565217391304
"E01000925",583,61,114,328,80,286,18,43,167,58,297,43,71,161,22,10.4631217838765,19.5540308747856,56.2607204116638,13.7221269296741,49.0566037735849,3.08747855917667,7.37564322469983,28.6449399656947,9.94854202401372,50.9433962264151,7.37564322469983,12.1783876500858,27.6157804459691,3.77358490566038
"E01000926",1103,75,107,753,168,553,29,40,371,113,550,46,67,382,55,6.79963735267452,9.70081595648232,68.2683590208522,15.2311876699909,50.1359927470535,2.62919310970082,3.62647325475975,33.6355394378966,10.2447869446963,49.8640072529465,4.17044424297371,6.07434270172257,34.6328195829556,4.98640072529465
"E01000927",998,80,128,573,217,538,37,44,322,135,460,43,84,251,82,8.01603206412826,12.8256513026052,57.4148296593186,21.7434869739479,53.9078156312625,3.70741482965932,4.40881763527054,32.2645290581162,13.5270541082164,46.0921843687375,4.30861723446894,8.41683366733467,25.1503006012024,8.21643286573146
"E01000928",846,81,127,477,161,440,25,41,265,109,406,56,86,212,52,9.57446808510638,15.0118203309693,56.3829787234042,19.0307328605201,52.0094562647754,2.95508274231678,4.84633569739953,31.3238770685579,12.8841607565012,47.9905437352246,6.6193853427896,10.1654846335697,25.0591016548463,6.14657210401891
"E01000929",641,72,113,353,103,330,27,47,182,74,311,45,66,171,29,11.2324492979719,17.6287051482059,55.0702028081123,16.0686427457098,51.4820592823713,4.21216848673947,7.33229329173167,28.393135725429,11.5444617784711,48.5179407176287,7.02028081123245,10.2964118564743,26.6770670826833,4.52418096723869
"E01000930",814,68,133,463,150,395,30,65,209,91,419,38,68,254,59,8.35380835380835,16.3390663390663,56.8796068796069,18.4275184275184,48.5257985257985,3.68550368550369,7.98525798525798,25.6756756756757,11.1793611793612,51.4742014742015,4.66830466830467,8.35380835380835,31.2039312039312,7.24815724815725
"E01000931",897,71,154,520,152,449,27,66,258,98,448,44,88,262,54,7.91527313266444,17.1683389074693,57.9710144927536,16.9453734671126,50.0557413600892,3.01003344481605,7.35785953177258,28.7625418060201,10.9253065774805,49.9442586399108,4.90523968784838,9.81047937569677,29.2084726867336,6.02006688963211
"E01000932",1223,79,110,691,343,662,39,44,334,245,561,40,66,357,98,6.45952575633688,8.99427636958299,56.5004088307441,28.0457890433361,54.1291905151267,3.18887980376124,3.5977105478332,27.3098937040065,20.0327064595258,45.8708094848733,3.27064595257563,5.3965658217498,29.1905151267375,8.0130825838103
"E01000933",1037,71,115,632,219,560,30,51,343,136,477,41,64,289,83,6.8466730954677,11.0896817743491,60.9450337512054,21.1186113789778,54.0019286403086,2.89296046287367,4.91803278688525,33.076181292189,13.1147540983607,45.9980713596914,3.95371263259402,6.17164898746384,27.8688524590164,8.00385728061717
"E01000934",663,72,141,370,80,358,32,77,196,53,305,40,64,174,27,10.8597285067873,21.2669683257919,55.8069381598793,12.0663650075415,53.9969834087481,4.82654600301659,11.6138763197587,29.5625942684766,7.99396681749623,46.0030165912519,6.03318250377074,9.65309200603318,26.2443438914027,4.07239819004525
"E01000935",594,48,124,333,89,300,20,51,174,55,294,28,73,159,34,8.08080808080808,20.8754208754209,56.0606060606061,14.983164983165,50.5050505050505,3.36700336700337,8.58585858585858,29.2929292929293,9.25925925925926,49.4949494949495,4.71380471380471,12.2895622895623,26.7676767676768,5.72390572390572
"E01000936",612,89,117,301,105,333,40,52,171,70,279,49,65,130,35,14.5424836601307,19.1176470588235,49.1830065359477,17.156862745098,54.4117647058823,6.5359477124183,8.49673202614379,27.9411764705882,11.437908496732,45.5882352941176,8.00653594771242,10.6209150326797,21.2418300653595,5.71895424836601
"E01000937",513,92,80,253,88,251,31,27,137,56,262,61,53,116,32,17.9337231968811,15.5945419103314,49.317738791423,17.1539961013645,48.9278752436647,6.04288499025341,5.26315789473684,26.7056530214425,10.916179337232,51.0721247563353,11.8908382066277,10.3313840155945,22.6120857699805,6.23781676413255
"E01000938",801,126,151,395,129,445,65,66,222,92,356,61,85,173,37,15.7303370786517,18.8514357053683,49.3133583021223,16.1048689138577,55.5555555555556,8.11485642946317,8.23970037453183,27.7153558052434,11.4856429463171,44.4444444444444,7.61548064918852,10.6117353308365,21.5980024968789,4.61922596754057
"E01000939",391,76,92,180,43,236,36,55,117,28,155,40,37,63,15,19.4373401534527,23.5294117647059,46.0358056265985,10.997442455243,60.3580562659847,9.20716112531969,14.0664961636829,29.923273657289,7.16112531969309,39.6419437340153,10.230179028133,9.46291560102302,16.1125319693095,3.83631713554987
"E01000940",394,60,65,209,60,211,20,24,124,43,183,40,41,85,17,15.2284263959391,16.497461928934,53.0456852791878,15.2284263959391,53.5532994923858,5.0761421319797,6.09137055837564,31.4720812182741,10.9137055837563,46.4467005076142,10.1522842639594,10.4060913705584,21.5736040609137,4.31472081218274
"E01000941",476,56,103,252,65,273,16,62,150,45,203,40,41,102,20,11.7647058823529,21.6386554621849,52.9411764705882,13.6554621848739,57.3529411764706,3.36134453781513,13.0252100840336,31.5126050420168,9.45378151260504,42.6470588235294,8.40336134453782,8.61344537815126,21.4285714285714,4.20168067226891
"E01000942",694,159,73,320,142,388,69,39,192,88,306,90,34,128,54,22.9106628242075,10.5187319884726,46.1095100864553,20.4610951008646,55.9077809798271,9.94236311239193,5.61959654178674,27.6657060518732,12.6801152737752,44.0922190201729,12.9682997118156,4.89913544668588,18.4438040345821,7.78097982708934
"E01000943",499,66,60,267,106,260,30,18,147,65,239,36,42,120,41,13.2264529058116,12.0240480961924,53.5070140280561,21.2424849699399,52.1042084168337,6.01202404809619,3.60721442885772,29.4589178356713,13.0260521042084,47.8957915831663,7.21442885771543,8.41683366733467,24.0480961923848,8.21643286573146
"E01000944",564,114,98,277,75,326,72,47,163,44,238,42,51,114,31,20.2127659574468,17.3758865248227,49.113475177305,13.2978723404255,57.8014184397163,12.7659574468085,8.33333333333333,28.9007092198582,7.80141843971631,42.1985815602837,7.4468085106383,9.04255319148936,20.2127659574468,5.49645390070922
"E01000945",667,140,118,299,110,332,41,57,158,76,335,99,61,141,34,20.9895052473763,17.6911544227886,44.8275862068966,16.4917541229385,49.7751124437781,6.14692653673163,8.54572713643178,23.688155922039,11.3943028485757,50.2248875562219,14.8425787106447,9.14542728635682,21.1394302848576,5.09745127436282
"E01000946",756,66,87,407,196,384,26,39,198,121,372,40,48,209,75,8.73015873015873,11.5079365079365,53.8359788359788,25.9259259259259,50.7936507936508,3.43915343915344,5.15873015873016,26.1904761904762,16.005291005291,49.2063492063492,5.29100529100529,6.34920634920635,27.6455026455026,9.92063492063492
"E01000947",1014,91,132,585,206,613,43,62,349,159,401,48,70,236,47,8.97435897435897,13.0177514792899,57.6923076923077,20.3155818540434,60.4536489151874,4.24063116370809,6.11439842209073,34.4181459566075,15.6804733727811,39.5463510848126,4.73372781065089,6.90335305719921,23.2741617357002,4.63510848126233
"E01000948",905,77,111,517,200,516,28,52,306,130,389,49,59,211,70,8.50828729281768,12.2651933701657,57.1270718232044,22.0994475138122,57.0165745856354,3.0939226519337,5.74585635359116,33.8121546961326,14.3646408839779,42.9834254143646,5.41436464088398,6.51933701657459,23.3149171270718,7.73480662983425
"E01000949",749,53,111,517,68,362,19,32,267,44,387,34,79,250,24,7.07610146862483,14.8197596795728,69.0253671562083,9.07877169559413,48.3311081441923,2.53671562082777,4.27236315086782,35.6475300400534,5.87449933244326,51.6688918558077,4.53938584779706,10.5473965287049,33.3778371161549,3.20427236315087
"E01000950",485,63,120,268,34,269,25,57,163,24,216,38,63,105,10,12.9896907216495,24.7422680412371,55.2577319587629,7.01030927835052,55.4639175257732,5.15463917525773,11.7525773195876,33.6082474226804,4.94845360824742,44.5360824742268,7.83505154639175,12.9896907216495,21.6494845360825,2.06185567010309
"E01000951",497,71,103,278,45,278,25,50,174,29,219,46,53,104,16,14.2857142857143,20.7243460764588,55.9356136820926,9.05432595573441,55.9356136820926,5.03018108651912,10.0603621730382,35.010060362173,5.83501006036217,44.0643863179074,9.25553319919517,10.6639839034205,20.9255533199195,3.21931589537223
"E01000952",654,76,143,360,75,331,26,58,192,55,323,50,85,168,20,11.6207951070336,21.8654434250765,55.045871559633,11.4678899082569,50.611620795107,3.97553516819572,8.86850152905199,29.3577981651376,8.40978593272171,49.388379204893,7.64525993883792,12.9969418960245,25.6880733944954,3.05810397553517
"E01000953",594,79,109,341,65,291,28,48,171,44,303,51,61,170,21,13.2996632996633,18.3501683501683,57.4074074074074,10.9427609427609,48.989898989899,4.71380471380471,8.08080808080808,28.7878787878788,7.40740740740741,51.010101010101,8.58585858585858,10.2693602693603,28.6195286195286,3.53535353535354
"E01000954",527,57,127,277,66,278,20,56,151,51,249,37,71,126,15,10.8159392789374,24.0986717267552,52.561669829222,12.5237191650854,52.7514231499051,3.79506641366224,10.6261859582543,28.6527514231499,9.67741935483871,47.2485768500949,7.02087286527514,13.4724857685009,23.9089184060721,2.84629981024668
"E01000955",523,72,132,257,62,271,32,65,124,50,252,40,67,133,12,13.7667304015296,25.2390057361377,49.1395793499044,11.8546845124283,51.8164435946463,6.11854684512428,12.4282982791587,23.7093690248566,9.56022944550669,48.1835564053537,7.64818355640535,12.810707456979,25.4302103250478,2.29445506692161
"E01000956",586,73,113,330,70,335,29,65,191,50,251,44,48,139,20,12.457337883959,19.2832764505119,56.3139931740614,11.9453924914676,57.1672354948805,4.94880546075085,11.0921501706485,32.5938566552901,8.53242320819113,42.8327645051194,7.50853242320819,8.19112627986348,23.7201365187713,3.41296928327645
"E01000957",829,78,127,513,111,443,35,64,279,65,386,43,63,234,46,9.40892641737033,15.3196622436671,61.8817852834741,13.3896260554885,53.437876960193,4.22195416164053,7.72014475271411,33.6550060313631,7.84077201447527,46.562123039807,5.1869722557298,7.59951749095295,28.226779252111,5.54885404101327
"E01000958",969,102,140,591,136,549,39,80,340,90,420,63,60,251,46,10.5263157894737,14.4478844169247,60.9907120743034,14.0350877192982,56.656346749226,4.02476780185759,8.25593395252838,35.0877192982456,9.28792569659443,43.343653250774,6.5015479876161,6.19195046439629,25.9029927760578,4.74716202270382
"E01000959",602,105,124,316,57,343,46,64,187,46,259,59,60,129,11,17.4418604651163,20.5980066445183,52.4916943521595,9.46843853820598,56.9767441860465,7.64119601328904,10.6312292358804,31.063122923588,7.64119601328904,43.0232558139535,9.80066445182724,9.96677740863787,21.4285714285714,1.82724252491694
"E01000960",926,71,118,478,259,474,25,55,229,165,452,46,63,249,94,7.66738660907127,12.7429805615551,51.6198704103672,27.9697624190065,51.1879049676026,2.69978401727862,5.93952483801296,24.7300215982721,17.8185745140389,48.8120950323974,4.96760259179266,6.80345572354212,26.889848812095,10.1511879049676
"E01000961",622,58,112,312,140,316,22,49,146,99,306,36,63,166,41,9.32475884244373,18.0064308681672,50.1607717041801,22.508038585209,50.8038585209003,3.53697749196141,7.87781350482315,23.4726688102894,15.9163987138264,49.1961414790997,5.78778135048232,10.1286173633441,26.6881028938907,6.59163987138264
"E01000962",1076,44,101,604,327,521,14,31,261,215,555,30,70,343,112,4.08921933085502,9.38661710037175,56.1338289962825,30.3903345724907,48.4200743494424,1.30111524163569,2.88104089219331,24.2565055762082,19.9814126394052,51.5799256505576,2.78810408921933,6.50557620817844,31.8773234200744,10.4089219330855
"E01000963",853,67,61,443,282,517,25,24,255,213,336,42,37,188,69,7.8546307151231,7.15123094958968,51.9343493552169,33.0597889800703,60.609613130129,2.93083235638921,2.81359906213365,29.89449003517,24.9706916764361,39.390386869871,4.92379835873388,4.33763188745604,22.0398593200469,8.08909730363423
"E01000964",842,43,96,444,259,427,15,32,207,173,415,28,64,237,86,5.10688836104513,11.4014251781473,52.7315914489311,30.7600950118765,50.7125890736342,1.78147268408551,3.80047505938242,24.58432304038,20.5463182897862,49.2874109263658,3.32541567695962,7.60095011876485,28.1472684085511,10.2137767220903
"E01000965",928,42,103,536,247,474,14,31,274,155,454,28,72,262,92,4.52586206896552,11.0991379310345,57.7586206896552,26.6163793103448,51.0775862068966,1.50862068965517,3.34051724137931,29.5258620689655,16.7025862068966,48.9224137931034,3.01724137931034,7.75862068965517,28.2327586206897,9.91379310344828
"E01000966",997,61,80,529,327,521,22,24,265,210,476,39,56,264,117,6.11835506519559,8.02407221664995,53.0591775325978,32.7983951855567,52.2567703109328,2.20661985957874,2.40722166499498,26.579739217653,21.0631895687061,47.7432296890672,3.91173520561685,5.61685055165496,26.4794383149448,11.7352056168506
"E01000967",684,50,77,337,220,363,15,22,173,153,321,35,55,164,67,7.30994152046784,11.2573099415205,49.2690058479532,32.1637426900585,53.0701754385965,2.19298245614035,3.21637426900585,25.2923976608187,22.3684210526316,46.9298245614035,5.11695906432749,8.04093567251462,23.9766081871345,9.7953216374269
"E01000968",973,60,75,566,272,478,16,26,269,167,495,44,49,297,105,6.16649537512847,7.70811921891059,58.1706063720452,27.9547790339157,49.1264131551901,1.64439876670092,2.672147995889,27.6464542651593,17.1634121274409,50.8735868448099,4.52209660842754,5.03597122302158,30.5241521068859,10.7913669064748
"E01000969",1369,65,120,782,402,683,22,37,365,259,686,43,83,417,143,4.74799123447772,8.76552227903579,57.1219868517166,29.3644996347699,49.8904309715121,1.60701241782323,2.7027027027027,26.6617969320672,18.9189189189189,50.1095690284879,3.14097881665449,6.06281957633309,30.4601899196494,10.445580715851
"E01000970",1098,44,79,639,336,558,14,28,325,191,540,30,51,314,145,4.00728597449909,7.19489981785064,58.1967213114754,30.6010928961749,50.8196721311475,1.27504553734062,2.55009107468124,29.5992714025501,17.3952641165756,49.1803278688525,2.73224043715847,4.6448087431694,28.5974499089253,13.2058287795993
"E01000971",903,54,112,519,218,458,16,35,266,141,445,38,77,253,77,5.98006644518272,12.4031007751938,57.4750830564784,24.1417497231451,50.7198228128461,1.7718715393134,3.87596899224806,29.4573643410853,15.6146179401993,49.2801771871539,4.20819490586932,8.52713178294574,28.0177187153931,8.52713178294574
"E01000972",985,73,116,594,202,500,24,43,309,124,485,49,73,285,78,7.41116751269036,11.7766497461929,60.3045685279188,20.507614213198,50.761421319797,2.43654822335025,4.36548223350254,31.3705583756345,12.5888324873096,49.238578680203,4.9746192893401,7.41116751269036,28.9340101522843,7.91878172588832
"E01000973",1149,73,118,693,265,564,24,50,336,154,585,49,68,357,111,6.35335073977372,10.2697998259356,60.313315926893,23.0635335073977,49.0861618798956,2.088772845953,4.35161009573542,29.242819843342,13.4029590948651,50.9138381201044,4.26457789382071,5.91818973020017,31.0704960835509,9.66057441253264
"E01000974",940,70,119,568,183,468,41,40,281,106,472,29,79,287,77,7.4468085106383,12.6595744680851,60.4255319148936,19.468085106383,49.7872340425532,4.36170212765957,4.25531914893617,29.8936170212766,11.2765957446809,50.2127659574468,3.08510638297872,8.40425531914894,30.531914893617,8.19148936170213
