"GeographyCode","QS115EW0001","QS115EW0002","QS115EW0003","QS115EW0004","QS115EW0005","QS115EW0006","QS115EW0007","QS115EW0008","QS115EW0009","QS115EW0010","QS115EW0011","QS115EW0012"
"E00004120",143,52,15,37,91,5,13,19,41,0,2,11
"E00004121",118,42,17,25,76,1,16,24,26,1,0,8
"E00004122",103,40,10,30,63,2,8,20,18,4,5,6
"E00004123",108,20,11,9,88,2,14,22,16,6,6,22
"E00004124",100,62,15,47,38,1,5,12,11,1,2,6
"E00004125",178,119,37,82,59,6,2,5,29,0,2,15
"E00004126",144,65,15,50,79,1,10,16,37,5,1,9
"E00004127",124,43,13,30,81,8,9,8,33,1,5,17
"E00004128",161,80,21,59,81,1,14,18,38,1,4,5
"E00004129",142,56,16,40,86,0,15,10,47,1,3,10
"E00004130",128,59,9,50,69,2,4,11,30,2,7,13
"E00004131",119,41,8,33,78,2,14,16,24,3,12,7
"E00004132",92,32,7,25,60,0,5,19,29,2,2,3
"E00004133",118,51,11,40,67,2,5,18,21,3,6,12
"E00004134",100,51,8,43,49,1,10,10,17,1,2,8
"E00004135",105,74,12,62,31,1,1,2,24,0,1,2
"E00004136",110,47,10,37,63,1,8,14,25,2,5,8
"E00004137",147,74,23,51,73,2,8,11,37,3,5,7
"E00004138",142,88,30,58,54,2,9,15,26,0,2,0
"E00004139",140,22,4,18,118,57,0,39,17,1,2,2
"E00004140",111,49,19,30,62,2,8,8,33,2,3,6
"E00004141",114,64,19,45,50,3,7,9,24,0,0,7
"E00004142",133,76,17,59,57,0,3,13,25,2,2,12
"E00004143",126,58,14,44,68,4,3,13,35,4,3,6
"E00004144",102,31,6,25,71,2,11,23,22,1,2,10
"E00004145",110,48,17,31,62,2,5,13,34,1,3,4
"E00004146",126,57,12,45,69,0,3,7,42,2,5,10
"E00004147",126,58,20,38,68,2,8,6,39,3,2,8
"E00004148",106,71,19,52,35,2,3,6,10,2,3,9
"E00004149",149,53,15,38,96,3,10,21,37,1,5,19
"E00004150",147,56,12,44,91,1,1,19,42,1,4,23
"E00004151",148,71,12,59,77,0,5,13,48,2,0,9
"E00004152",113,51,19,32,62,0,10,15,18,4,6,9
"E00004153",108,51,6,45,57,1,9,10,27,1,4,5
"E00004154",122,48,8,40,74,2,4,16,36,0,11,5
"E00004155",103,33,3,30,70,0,5,19,21,4,7,14
"E00004156",126,69,22,47,57,5,5,19,22,1,0,5
"E00004157",94,30,9,21,64,3,6,18,18,1,4,14
"E00004158",124,57,11,46,67,8,5,11,19,3,8,13
"E00004159",160,62,13,49,98,25,14,15,11,4,18,11
"E00004160",103,46,35,11,57,12,12,5,10,3,2,13
"E00004161",96,37,12,25,59,3,7,7,23,4,1,14
"E00004162",128,56,5,51,72,1,5,16,38,2,3,7
"E00004163",163,59,13,46,104,11,8,21,34,7,9,14
"E00004164",160,62,19,43,98,18,12,12,14,8,12,22
"E00004165",146,57,18,39,89,14,14,16,15,4,10,16
"E00004166",157,57,20,37,100,19,11,14,14,11,16,15
"E00004167",99,20,10,10,79,3,16,20,11,7,7,15
"E00004168",109,58,21,37,51,0,7,15,20,1,0,8
"E00004169",149,70,19,51,79,1,9,8,30,0,2,29
"E00004172",148,85,9,76,63,4,6,4,38,1,0,10
"E00004173",127,83,35,48,44,0,13,4,17,0,1,9
"E00004174",131,68,22,46,63,5,4,8,9,2,4,31
"E00004175",128,73,19,54,55,8,3,4,20,2,1,17
"E00004177",74,53,9,44,21,0,5,2,10,0,0,4
"E00004179",190,113,58,55,77,9,18,7,19,5,4,15
"E00004180",128,58,11,47,70,20,3,4,20,0,2,21
"E00004181",212,127,81,46,85,9,31,8,18,4,4,11
"E00004182",76,39,13,26,37,1,1,5,14,2,5,9
"E00004183",106,59,15,44,47,10,2,5,16,2,3,9
"E00004184",112,56,16,40,56,5,10,8,18,0,3,12
"E00004185",171,71,13,58,100,24,3,3,22,5,3,40
"E00004187",226,95,12,83,131,3,10,8,58,2,8,42
"E00004188",109,65,7,58,44,0,6,2,17,1,0,18
"E00004189",118,45,4,41,73,0,2,5,26,0,0,40
"E00004190",384,313,71,242,71,0,14,2,46,0,0,9
"E00004193",119,50,12,38,69,1,8,6,27,0,2,25
"E00004194",144,79,14,65,65,4,4,3,35,1,2,16
"E00004195",133,50,16,34,83,2,3,3,37,3,3,32
"E00004196",101,50,26,24,51,0,11,3,18,1,5,13
"E00004197",116,45,17,28,71,0,11,5,29,0,1,25
"E00004198",182,87,12,75,95,0,4,6,47,1,2,35
"E00004199",163,89,14,75,74,2,5,13,35,0,2,17
"E00004200",136,75,13,62,61,2,2,2,33,1,3,18
"E00004201",144,69,18,51,75,4,18,14,26,3,4,6
"E00004202",160,153,94,59,7,1,4,0,0,0,0,2
"E00004203",164,65,9,56,99,5,12,6,49,1,1,25
"E00004204",149,58,17,41,91,2,22,14,42,2,3,6
"E00004205",145,36,7,29,109,2,11,22,40,3,8,23
"E00004206",127,48,18,30,79,11,6,12,13,3,9,25
"E00004207",128,38,10,28,90,10,5,6,19,12,19,19
"E00004208",125,42,16,26,83,15,10,15,15,0,10,18
"E00004209",113,40,6,34,73,0,6,5,23,3,5,31
"E00004210",126,46,12,34,80,13,7,17,12,9,6,16
"E00004211",124,44,3,41,80,1,4,3,28,5,9,30
"E00004212",134,42,7,35,92,3,7,14,33,9,5,21
"E00004213",167,49,6,43,118,15,7,15,30,5,23,23
"E00004214",243,108,9,99,135,14,1,23,51,6,15,25
"E00004215",129,58,12,46,71,3,6,12,29,4,2,15
"E00004216",146,69,13,56,77,3,7,23,24,1,7,12
"E00004217",141,76,11,65,65,0,5,12,35,1,1,11
"E00004218",131,49,21,28,82,6,9,5,25,5,9,23
"E00004219",190,102,19,83,88,10,4,17,29,0,4,24
"E00004220",87,44,22,22,43,3,10,5,10,4,3,8
"E00004221",111,43,14,29,68,0,6,17,29,5,1,10
"E00004222",109,55,11,44,54,2,5,10,21,3,4,9
"E00004223",116,35,6,29,81,3,0,12,22,6,9,29
"E00004224",147,77,11,66,70,1,4,16,28,2,5,14
"E00004225",195,82,2,80,113,5,3,4,66,1,4,30
"E00004226",119,52,21,31,67,1,9,15,16,4,5,17
"E00004227",145,75,15,60,70,4,13,13,28,1,3,8
"E00004228",107,49,11,38,58,0,12,7,26,5,2,6
"E00004229",174,74,8,66,100,8,9,7,61,2,1,12
"E00004230",130,56,7,49,74,4,8,10,26,0,6,20
"E00004231",142,51,11,40,91,0,10,26,30,6,4,15
"E00004232",132,88,47,41,44,0,14,7,18,3,1,1
"E00004233",124,58,23,35,66,3,8,8,29,1,4,13
"E00004234",124,46,15,31,78,2,10,16,41,1,1,7
"E00004235",163,72,12,60,91,13,3,9,42,2,3,19
"E00004236",150,62,4,58,88,4,4,3,36,2,5,34
"E00004237",123,44,6,38,79,8,4,6,37,3,6,15
"E00004238",126,45,16,29,81,2,13,16,21,2,5,22
"E00004239",111,59,18,41,52,5,5,11,15,0,4,12
"E00004240",136,51,5,46,85,6,8,5,27,2,11,26
"E00004241",133,44,13,31,89,1,16,18,31,3,5,15
"E00004242",105,71,3,68,34,1,1,10,12,2,3,5
"E00004243",110,26,7,19,84,0,13,17,22,6,11,15
"E00004244",100,36,8,28,64,10,3,9,6,5,17,14
"E00004245",163,74,20,54,89,4,18,11,35,4,2,15
"E00004246",121,51,12,39,70,6,4,9,26,5,5,15
"E00004247",156,64,23,41,92,5,12,10,40,4,2,19
"E00004248",207,91,13,78,116,10,9,17,37,6,10,27
"E00004249",114,40,5,35,74,6,7,7,38,1,3,12
"E00004250",127,54,11,43,73,2,2,9,30,4,5,21
"E00004251",95,33,4,29,62,1,10,8,13,2,11,17
"E00004252",115,46,7,39,69,3,8,12,24,2,8,12
"E00004253",132,49,13,36,83,5,11,7,34,2,7,17
"E00004254",119,38,10,28,81,12,6,18,14,4,11,16
"E00004255",128,50,11,39,78,11,1,12,28,2,3,21
"E00004256",149,46,28,18,103,9,4,13,41,3,9,24
"E00004257",113,28,4,24,85,9,7,16,37,0,4,12
"E00004258",111,46,6,40,65,2,2,4,24,0,1,32
"E00004259",104,32,10,22,72,20,8,6,7,6,8,17
"E00004260",136,92,12,80,44,7,2,12,13,1,5,4
"E00004261",114,44,11,33,70,4,6,4,23,8,5,20
"E00004262",114,40,10,30,74,13,3,17,19,7,5,10
"E00004263",121,23,5,18,98,16,4,21,17,10,17,13
"E00004264",176,68,12,56,108,5,3,11,59,0,0,30
"E00004265",112,54,15,39,58,11,1,7,16,1,3,19
"E00004266",156,71,21,50,85,5,2,15,31,6,5,21
"E00004268",142,70,11,59,72,6,1,14,23,2,12,14
"E00004269",121,51,21,30,70,8,4,9,35,0,4,10
"E00004270",189,62,12,50,127,8,4,14,56,4,10,31
"E00004271",142,44,10,34,98,7,5,14,37,3,3,29
"E00004272",113,27,10,17,86,1,19,14,24,1,8,19
"E00004273",159,53,16,37,106,2,14,9,38,2,7,34
"E00004274",130,43,8,35,87,5,5,15,34,2,3,23
"E00004275",104,44,13,31,60,5,4,7,31,1,0,12
"E00004276",122,44,15,29,78,7,8,18,21,1,1,22
"E00004277",135,63,15,48,72,6,4,12,37,0,2,11
"E00004278",102,37,8,29,65,9,4,8,24,2,2,16
"E00004279",134,50,7,43,84,9,10,11,35,1,8,10
"E00004280",108,44,4,40,64,2,17,7,25,1,6,6
"E00004281",115,33,6,27,82,5,10,13,39,0,4,11
"E00004282",149,64,14,50,85,13,4,12,35,1,6,14
"E00004283",137,65,8,57,72,4,8,11,32,0,6,11
"E00004284",128,62,13,49,66,7,7,8,24,2,3,15
"E00004285",144,69,10,59,75,0,7,11,38,0,2,17
"E00004286",158,70,23,47,88,7,6,7,45,1,3,19
"E00004287",111,32,7,25,79,9,8,9,27,1,3,22
"E00004288",166,80,8,72,86,6,6,8,44,2,6,14
"E00004289",129,64,7,57,65,0,3,8,41,1,1,11
"E00004290",164,77,11,66,87,5,4,13,48,2,2,13
"E00004291",138,50,16,34,88,7,12,13,18,3,9,26
"E00004292",121,40,14,26,81,18,6,9,8,11,14,15
"E00004293",119,46,13,33,73,9,5,6,22,4,7,20
"E00004294",119,61,19,42,58,2,2,10,28,1,0,15
"E00004295",175,68,15,53,107,1,11,11,42,4,7,31
"E00004296",133,42,12,30,91,12,6,12,15,5,22,19
"E00004297",154,67,4,63,87,4,8,14,36,1,0,24
"E00004298",112,24,7,17,88,3,9,11,26,2,18,19
"E00004299",135,45,19,26,90,4,13,22,31,4,4,12
"E00004300",111,37,11,26,74,4,4,16,22,0,8,20
"E00004301",241,110,9,101,131,11,6,18,51,2,9,34
"E00004302",143,59,9,50,84,5,7,14,33,4,6,15
"E00004303",113,22,10,12,91,1,16,17,15,1,8,33
"E00004304",178,63,10,53,115,5,10,22,40,1,5,32
"E00004305",134,32,10,22,102,2,13,27,24,7,5,24
"E00004306",157,65,17,48,92,4,17,17,32,0,4,18
"E00004307",150,44,19,25,106,5,15,26,26,3,6,25
"E00004308",123,44,9,35,79,6,5,13,26,3,4,22
"E00004309",115,30,2,28,85,0,5,22,31,5,4,18
"E00004310",128,38,11,27,90,2,12,24,25,3,4,20
"E00004311",99,27,7,20,72,0,6,16,18,7,10,15
"E00004312",150,62,13,49,88,7,6,22,23,1,3,26
"E00004313",131,42,11,31,89,2,14,19,33,0,4,17
"E00004314",153,68,7,61,85,4,2,14,37,1,8,19
"E00004315",154,50,12,38,104,1,11,16,57,0,0,19
"E00004316",122,51,5,46,71,2,4,6,35,1,2,21
"E00004317",161,44,8,36,117,6,6,18,47,2,7,31
"E00004318",126,41,12,29,85,3,6,12,25,1,6,32
"E00004319",143,57,10,47,86,5,4,7,54,0,2,14
"E00004320",112,31,9,22,81,0,16,17,23,5,6,14
"E00004321",114,29,16,13,85,4,10,18,28,5,5,15
"E00004322",114,31,13,18,83,1,18,20,13,6,4,21
"E00004323",96,23,3,20,73,5,5,18,27,3,5,10
"E00004324",122,42,14,28,80,1,13,28,15,5,3,15
"E00004325",113,57,19,38,56,2,11,15,11,6,3,8
"E00004326",117,61,12,49,56,3,7,10,11,13,6,6
"E00004327",140,52,15,37,88,5,13,26,23,3,7,11
"E00004328",95,29,14,15,66,1,11,14,18,3,3,16
"E00004329",124,41,10,31,83,4,5,16,33,10,4,11
"E00004330",146,61,7,54,85,3,2,17,50,5,0,8
"E00004331",112,39,10,29,73,1,7,8,30,6,6,15
"E00004332",87,32,17,15,55,3,5,15,21,2,3,6
"E00004333",133,58,16,42,75,2,9,10,38,3,2,11
"E00004334",106,53,12,41,53,0,9,14,20,4,2,4
"E00004335",145,57,7,50,88,4,10,14,44,2,4,10
"E00004336",175,77,6,71,98,1,4,10,57,8,4,14
"E00004337",114,41,13,28,73,1,11,23,19,2,2,15
"E00004338",112,32,14,18,80,1,13,20,28,9,2,7
"E00004339",112,37,12,25,75,3,11,9,38,3,2,9
"E00004340",95,32,4,28,63,2,6,4,19,0,5,27
"E00004341",132,68,14,54,64,2,4,17,32,0,0,9
"E00004342",94,35,7,28,59,3,7,13,27,1,2,6
"E00004343",120,54,11,43,66,2,6,16,33,1,2,6
"E00004344",118,50,13,37,68,2,6,14,29,0,3,14
"E00004345",121,25,11,14,96,4,28,18,16,5,7,18
"E00004346",94,23,16,7,71,2,15,21,14,3,3,13
"E00004347",97,33,13,20,64,1,2,14,20,6,9,12
"E00004348",131,59,9,50,72,5,5,15,28,6,5,8
"E00004349",117,22,12,10,95,2,13,30,14,8,9,19
"E00004350",125,41,21,20,84,4,25,15,24,5,2,9
"E00004351",131,52,16,36,79,3,27,13,18,3,5,10
"E00004352",118,36,14,22,82,3,13,18,19,4,12,13
"E00004353",137,60,25,35,77,1,29,12,27,1,4,3
"E00004354",108,33,11,22,75,0,20,15,17,1,5,17
"E00004355",122,43,11,32,79,2,21,19,17,1,3,16
"E00004356",121,40,9,31,81,2,7,19,21,7,12,13
"E00004357",118,23,7,16,95,2,3,34,23,13,9,11
"E00004358",114,43,19,24,71,1,10,17,12,2,7,22
"E00004359",121,31,14,17,90,2,17,26,19,9,3,14
"E00004360",118,35,16,19,83,3,10,16,26,6,5,17
"E00004361",99,34,13,21,65,4,15,5,16,2,3,20
"E00004362",127,37,10,27,90,13,5,20,16,4,12,20
"E00004363",153,53,22,31,100,10,11,12,19,8,19,21
"E00004364",225,94,13,81,131,21,11,19,31,6,8,35
"E00004365",139,64,12,52,75,2,2,16,45,1,0,9
"E00004366",165,109,22,87,56,9,7,13,11,4,4,8
"E00004367",148,55,16,39,93,17,10,14,23,5,8,16
"E00004368",175,79,22,57,96,1,13,20,35,4,7,16
"E00004369",123,48,26,22,75,12,17,10,12,3,7,14
"E00004370",117,60,36,24,57,4,8,10,14,1,6,14
"E00004371",103,42,7,35,61,12,9,8,16,4,6,6
"E00004372",109,32,11,21,77,6,7,17,11,3,10,23
"E00004373",146,51,21,30,95,15,13,7,23,7,9,21
"E00004374",97,31,5,26,66,23,2,9,13,2,6,11
"E00004375",119,45,23,22,74,3,12,16,25,2,2,14
"E00004376",176,72,12,60,104,14,10,17,23,3,10,27
"E00004377",95,40,13,27,55,17,3,6,8,3,6,12
"E00004378",137,45,6,39,92,6,13,16,33,6,3,15
"E00004379",135,52,17,35,83,5,10,14,36,0,4,14
"E00004380",152,72,39,33,80,3,5,8,32,5,15,12
"E00004381",117,35,9,26,82,5,5,12,28,5,5,22
"E00004382",139,60,11,49,79,4,6,18,35,5,3,8
"E00004383",103,45,6,39,58,2,8,7,22,2,4,13
"E00004384",101,39,8,31,62,5,11,13,12,2,4,15
"E00004385",91,25,2,23,66,5,5,16,21,3,5,11
"E00004386",101,25,8,17,76,4,10,13,25,3,9,12
"E00004387",89,26,11,15,63,1,5,10,29,1,5,12
"E00004388",99,30,7,23,69,2,4,13,27,3,6,14
"E00004389",108,26,4,22,82,4,9,15,22,5,6,21
"E00004390",113,31,10,21,82,4,9,16,29,2,5,17
"E00004391",128,42,12,30,86,1,8,25,25,4,5,18
"E00004392",95,25,12,13,70,3,17,15,11,3,4,17
"E00004393",113,29,8,21,84,9,7,19,24,5,3,17
"E00004394",94,37,6,31,57,15,1,10,18,1,1,11
"E00004395",133,67,13,54,66,7,4,10,25,3,4,13
"E00004396",131,63,10,53,68,14,5,8,16,2,8,15
"E00004397",106,35,2,33,71,11,5,6,13,3,12,21
"E00004398",99,32,8,24,67,7,12,12,15,2,6,13
"E00004399",131,20,9,11,111,19,15,17,13,9,16,22
"E00004400",180,96,27,69,84,13,21,7,17,3,10,13
"E00004401",128,43,17,26,85,0,22,18,23,5,6,11
"E00004402",127,56,10,46,71,0,13,19,26,1,3,9
"E00004403",128,37,12,25,91,2,29,8,26,5,4,17
"E00004404",116,36,21,15,80,2,22,20,15,5,4,12
"E00004405",128,45,9,36,83,3,13,20,23,6,9,9
"E00004406",117,47,18,29,70,2,21,10,19,2,10,6
"E00004407",118,36,10,26,82,2,24,20,13,3,5,15
"E00004408",106,25,11,14,81,3,11,25,22,3,6,11
"E00004409",108,36,14,22,72,3,11,12,19,1,7,19
"E00004410",120,41,15,26,79,9,12,19,26,3,4,6
"E00004411",114,39,6,33,75,4,15,17,21,1,5,12
"E00004412",128,52,15,37,76,2,12,15,26,2,6,13
"E00004413",101,39,5,34,62,2,5,27,13,8,2,5
"E00004414",123,45,10,35,78,1,12,16,20,4,7,18
"E00004415",139,54,15,39,85,3,8,25,31,2,5,11
"E00004416",114,45,20,25,69,3,10,17,19,4,5,11
"E00004417",125,41,12,29,84,1,13,18,31,4,5,12
"E00004418",114,43,13,30,71,1,14,18,13,2,6,17
"E00004419",126,58,10,48,68,3,2,11,36,2,2,12
"E00004420",112,35,14,21,77,0,19,15,17,7,4,15
"E00004421",123,33,11,22,90,1,4,25,38,5,2,15
"E00004422",92,39,17,22,53,0,7,11,25,1,1,8
"E00004423",122,57,18,39,65,9,6,13,21,2,5,9
"E00004424",117,43,10,33,74,2,8,14,38,0,2,10
"E00004425",140,32,13,19,108,2,18,25,28,5,7,23
"E00004426",143,58,19,39,85,2,15,18,31,3,5,11
"E00004427",117,34,23,11,83,1,22,21,13,9,6,11
"E00004428",131,77,32,45,54,1,8,21,20,1,0,3
"E00004429",127,56,13,43,71,4,9,13,31,0,3,11
"E00004430",125,98,69,29,27,0,5,4,11,0,0,7
"E00004431",106,24,13,11,82,1,16,25,26,7,2,5
"E00004432",135,54,15,39,81,0,13,16,37,3,4,8
"E00004433",139,47,17,30,92,0,10,26,41,4,2,9
"E00004435",119,62,24,38,57,6,6,6,17,0,5,17
"E00004436",166,70,29,41,96,2,22,16,33,3,2,18
"E00004437",116,39,7,32,77,0,18,15,24,4,5,11
"E00004438",118,66,5,61,52,0,4,9,25,2,2,10
"E00004439",113,42,13,29,71,1,17,21,20,2,5,5
"E00004440",112,37,17,20,75,2,14,22,22,3,3,9
"E00004441",115,43,9,34,72,0,6,17,23,3,2,21
"E00004442",109,54,34,20,55,7,5,10,9,1,9,14
"E00004444",160,47,6,41,113,21,8,14,21,13,15,21
"E00004445",105,41,11,30,64,4,5,7,20,0,7,21
"E00004446",118,32,12,20,86,11,7,10,26,8,5,19
"E00004447",77,59,48,11,18,0,5,4,6,0,1,2
"E00004448",142,56,13,43,86,8,8,17,25,1,10,17
"E00004450",175,60,11,49,115,9,13,9,50,2,9,23
"E00004451",118,53,14,39,65,4,3,11,21,0,7,19
"E00004452",143,47,11,36,96,6,10,16,45,2,9,8
"E00004453",144,37,14,23,107,11,14,12,15,5,18,32
"E00004454",189,71,14,57,118,21,6,22,20,10,11,28
"E00004455",123,34,13,21,89,15,3,26,15,6,9,15
"E00004456",124,40,13,27,84,22,6,14,9,2,14,17
"E00004457",117,42,8,34,75,2,7,20,29,1,3,13
"E00004458",182,57,13,44,125,11,9,26,39,4,10,26
"E00004459",154,77,41,36,77,19,4,18,20,6,4,6
"E00004460",100,44,14,30,56,15,4,10,10,3,5,9
"E00004461",131,20,3,17,111,26,8,13,20,6,13,25
"E00004462",114,46,21,25,68,4,6,10,27,3,3,15
"E00004463",139,47,9,38,92,19,8,17,16,10,8,14
"E00004464",89,73,54,19,16,0,12,0,1,0,0,3
"E00004465",166,56,23,33,110,15,18,12,30,4,4,27
"E00004466",121,44,10,34,77,0,10,7,49,0,0,11
"E00004467",133,44,13,31,89,8,12,10,29,2,10,18
"E00004468",143,30,10,20,113,23,11,8,11,9,15,36
"E00004469",122,48,24,24,74,1,15,13,24,2,3,16
"E00004470",140,52,10,42,88,8,8,12,32,1,10,17
"E00004471",117,49,11,38,68,0,5,7,40,1,2,13
"E00004472",156,53,8,45,103,8,8,9,45,3,6,24
"E00004473",124,53,17,36,71,1,16,11,29,3,2,9
"E00004474",142,30,10,20,112,3,13,20,39,1,2,34
"E00004475",123,36,12,24,87,22,4,9,24,2,9,17
"E00004476",134,46,12,34,88,15,8,4,17,14,9,21
"E00004477",163,70,23,47,93,4,13,10,48,1,1,16
"E00004478",220,97,10,87,123,5,7,20,59,3,4,25
"E00004479",141,55,10,45,86,6,8,8,39,5,5,15
"E00004480",116,57,27,30,59,2,3,9,27,0,2,16
"E00004481",133,41,13,28,92,20,11,11,19,2,5,24
"E00004482",121,33,9,24,88,3,12,16,26,2,7,22
"E00004483",114,30,4,26,84,0,10,18,22,1,6,27
"E00004484",112,20,4,16,92,7,5,14,30,4,5,27
"E00004485",123,45,11,34,78,3,12,14,28,3,8,10
"E00004486",116,35,21,14,81,0,13,15,17,2,7,27
"E00004487",112,56,10,46,56,9,4,10,14,2,1,16
"E00004488",82,31,11,20,51,8,7,11,4,3,9,9
"E00004489",120,39,14,25,81,7,8,17,22,1,9,17
"E00004490",94,28,12,16,66,7,6,9,19,0,10,15
"E00004491",149,72,37,35,77,15,7,10,15,1,5,24
"E00004492",128,31,9,22,97,0,21,20,26,5,9,16
"E00004493",118,61,10,51,57,8,4,24,16,0,0,5
"E00004494",182,65,24,41,117,2,17,25,45,2,5,21
"E00004495",126,47,25,22,79,0,25,15,25,1,2,11
"E00004496",151,44,18,26,107,3,31,16,35,2,5,15
"E00004497",117,43,8,35,74,12,6,10,24,4,7,11
"E00004498",145,45,14,31,100,25,10,16,27,4,3,15
"E00004499",135,23,9,14,112,3,24,25,15,11,9,25
"E00004500",131,98,17,81,33,5,3,3,21,0,0,1
"E00004501",76,43,13,30,33,6,5,4,18,0,0,0
"E00004502",120,49,14,35,71,15,9,7,21,1,3,15
"E00004503",132,87,30,57,45,8,3,9,15,2,1,7
"E00004504",117,17,13,4,100,0,18,15,12,6,9,40
"E00004505",124,37,12,25,87,13,7,20,25,1,4,17
"E00004506",133,59,8,51,74,12,8,7,17,2,10,18
"E00004507",104,31,12,19,73,2,21,18,8,8,3,13
"E00004508",150,61,32,29,89,3,20,16,32,1,1,16
"E00004509",122,34,16,18,88,4,14,14,17,3,14,22
"E00004510",128,45,8,37,83,3,11,13,19,3,5,29
"E00004511",144,42,13,29,102,3,15,10,33,2,10,29
"E00004512",120,46,21,25,74,7,11,8,30,0,11,7
"E00004513",102,32,14,18,70,1,11,12,11,7,10,18
"E00004514",116,32,9,23,84,1,20,9,22,5,8,19
"E00004515",121,40,7,33,81,3,15,10,34,1,6,12
"E00004516",133,34,15,19,99,2,9,14,25,5,7,37
"E00004517",109,40,17,23,69,2,4,10,19,2,11,21
"E00004518",116,48,19,29,68,10,8,13,21,3,0,13
"E00004519",112,35,13,22,77,5,11,25,13,3,7,13
"E00004520",140,82,5,77,58,9,2,13,19,4,4,7
"E00004521",127,46,18,28,81,4,10,6,34,0,1,26
"E00004522",117,63,5,58,54,0,8,3,26,0,1,16
"E00004523",244,113,11,102,131,12,9,8,49,2,22,29
"E00004524",216,118,27,91,98,2,9,7,51,0,4,25
"E00004525",119,58,12,46,61,8,2,3,17,1,6,24
"E00004526",125,73,36,37,52,2,12,6,8,2,8,14
"E00004527",102,60,20,40,42,3,4,1,22,0,0,12
"E00004528",170,103,25,78,67,3,2,4,29,2,10,17
"E00004529",207,91,6,85,116,3,4,6,56,1,14,32
"E00004530",141,94,15,79,47,0,1,2,24,0,6,14
"E00004531",119,39,9,30,80,4,5,14,26,4,6,21
"E00004532",168,77,5,72,91,4,6,11,41,1,6,22
"E00004534",114,49,12,37,65,23,3,10,15,0,8,6
"E00004535",124,67,9,58,57,0,2,7,44,0,1,3
"E00004536",138,57,7,50,81,0,12,3,58,0,0,8
"E00004537",85,39,12,27,46,6,5,8,17,1,1,8
"E00004538",103,62,23,39,41,8,4,4,9,0,3,13
"E00004539",79,46,9,37,33,3,0,2,19,1,1,7
"E00004540",156,67,39,28,89,11,15,13,16,4,7,23
"E00004541",113,61,9,52,52,7,2,15,16,2,5,5
"E00004542",178,74,17,57,104,13,14,11,45,4,4,13
"E00004543",126,66,5,61,60,4,4,4,33,1,1,13
"E00004544",98,27,12,15,71,4,8,16,8,4,9,22
"E00004545",199,84,21,63,115,11,5,26,33,10,11,19
"E00004546",143,85,25,60,58,3,14,3,26,1,1,10
"E00004547",164,81,17,64,83,2,11,8,27,6,8,21
"E00004548",138,83,19,64,55,4,6,4,34,0,0,7
"E00004549",124,42,11,31,82,15,6,15,23,4,4,15
"E00004550",146,50,9,41,96,10,10,6,27,5,9,29
"E00004551",208,85,2,83,123,4,4,10,72,5,6,22
"E00004552",126,45,11,34,81,8,10,12,15,4,11,21
"E00004553",113,47,7,40,66,7,2,11,20,4,10,12
"E00004554",217,94,7,87,123,2,6,4,80,1,3,27
"E00004555",127,42,18,24,85,10,8,12,23,8,7,17
"E00004556",143,73,23,50,70,8,4,9,22,2,10,15
"E00004557",121,80,23,57,41,8,3,7,22,1,0,0
"E00004558",142,66,13,53,76,3,15,1,29,1,8,19
"E00004559",153,63,20,43,90,1,12,16,23,5,5,28
"E00004560",121,71,24,47,50,5,9,8,12,2,6,8
"E00004561",128,61,8,53,67,0,3,4,34,3,2,21
"E00004562",123,50,17,33,73,11,4,7,22,0,4,25
"E00004563",195,67,13,54,128,11,5,14,33,5,16,44
"E00004564",118,32,1,31,86,4,5,6,30,2,2,37
"E00004565",145,81,56,25,64,13,8,6,8,4,13,12
"E00004566",140,68,17,51,72,5,6,12,28,2,7,12
"E00004567",128,25,10,15,103,17,6,14,14,10,16,26
"E00004568",157,55,10,45,102,8,7,8,36,2,8,33
"E00004569",161,76,17,59,85,6,9,11,30,2,5,22
"E00004570",131,29,17,12,102,6,20,18,27,4,2,25
"E00004571",151,47,14,33,104,5,8,13,46,2,6,24
"E00004572",160,39,7,32,121,10,4,18,45,2,4,38
"E00004573",149,58,14,44,91,8,7,15,30,1,5,25
"E00004574",143,32,11,21,111,0,13,21,29,3,2,43
"E00004575",184,81,7,74,103,4,6,12,63,2,5,11
"E00004576",140,35,6,29,105,19,17,19,23,2,7,18
"E00004577",124,41,18,23,83,8,8,11,27,2,8,19
"E00004578",154,75,6,69,79,7,1,10,47,1,3,10
"E00004579",105,33,7,26,72,7,8,14,22,1,5,15
"E00004580",151,58,6,52,93,9,6,15,45,0,3,15
"E00004581",101,30,7,23,71,6,2,14,25,0,6,18
"E00004582",127,51,10,41,76,7,7,17,21,4,6,14
"E00004583",142,48,17,31,94,8,13,13,21,4,13,22
"E00004584",171,77,11,66,94,4,6,24,27,1,3,29
"E00004585",134,56,16,40,78,5,3,18,38,1,2,11
"E00004586",116,41,13,28,75,1,8,4,40,0,9,13
"E00004587",121,45,7,38,76,15,5,10,22,0,5,19
"E00004588",154,58,5,53,96,4,6,9,53,0,9,15
"E00004589",125,57,10,47,68,1,7,16,18,5,5,16
"E00004590",99,41,6,35,58,1,3,10,22,3,5,14
"E00004591",112,38,7,31,74,14,6,9,24,3,6,12
"E00004592",99,49,8,41,50,1,3,9,18,1,4,14
"E00004593",229,86,14,72,143,8,2,21,52,1,19,40
"E00004594",124,48,6,42,76,5,7,12,32,2,5,13
"E00004595",104,30,10,20,74,4,7,15,19,3,5,21
"E00004596",108,44,12,32,64,6,5,12,23,3,1,14
"E00004597",214,62,14,48,152,9,6,13,28,0,2,94
"E00004598",106,38,7,31,68,5,6,6,27,2,5,17
"E00004599",161,66,8,58,95,4,15,15,41,1,3,16
"E00004600",124,34,9,25,90,21,6,10,11,4,11,27
"E00004601",117,45,15,30,72,7,4,18,16,7,5,15
"E00004602",115,35,7,28,80,1,6,12,40,3,5,13
"E00004603",131,48,20,28,83,5,6,12,18,6,12,24
"E00004604",136,72,12,60,64,9,10,12,18,2,4,9
"E00004605",113,41,15,26,72,7,4,11,17,3,11,19
"E00004606",169,67,21,46,102,8,11,20,31,4,7,21
"E00004607",132,89,52,37,43,7,10,4,18,0,0,4
"E00004608",133,43,13,30,90,9,9,20,20,6,12,14
"E00004609",221,120,30,90,101,15,5,21,40,3,5,12
"E00004610",123,55,13,42,68,3,11,8,23,2,6,15
"E00004611",157,137,101,36,20,2,7,1,4,0,1,5
"E00004612",142,61,16,45,81,11,6,8,26,2,12,16
"E00004613",125,61,19,42,64,9,5,11,22,3,4,10
"E00004614",224,73,10,63,151,15,6,26,59,7,4,34
"E00004615",102,42,9,33,60,2,5,4,26,2,2,19
"E00004616",133,45,4,41,88,1,7,13,46,1,2,18
"E00004617",114,51,9,42,63,1,2,13,36,0,0,11
"E00004618",125,61,15,46,64,3,3,6,36,1,2,13
"E00004619",123,60,23,37,63,8,1,5,23,1,6,19
"E00004620",141,63,11,52,78,15,3,6,39,1,1,13
"E00004621",133,49,11,38,84,8,13,7,28,0,7,21
"E00004622",209,80,14,66,129,13,7,7,70,0,2,30
"E00004623",151,58,19,39,93,3,7,12,38,4,6,23
"E00004624",120,36,10,26,84,4,7,12,33,2,3,23
"E00004625",172,84,18,66,88,10,7,19,32,4,4,12
"E00004626",235,135,47,88,100,10,5,19,49,2,3,12
"E00004627",98,48,16,32,50,5,6,11,19,3,3,3
"E00004628",91,28,7,21,63,17,3,22,9,3,4,5
"E00004629",117,44,6,38,73,1,5,7,44,0,3,13
"E00004630",104,46,6,40,58,1,1,7,37,2,0,10
"E00004631",130,65,33,32,65,3,11,7,24,0,4,16
"E00004632",95,34,8,26,61,16,4,17,8,7,2,7
"E00004633",102,45,16,29,57,4,3,8,11,4,8,19
"E00004634",145,60,8,52,85,4,5,8,43,2,3,20
"E00004635",125,50,13,37,75,15,1,16,19,5,8,11
"E00004636",113,39,9,30,74,15,9,9,17,3,8,13
"E00004637",121,59,15,44,62,11,6,8,20,2,6,9
"E00004638",158,77,19,58,81,5,2,12,31,3,3,25
"E00004639",96,44,7,37,52,4,3,10,17,6,6,6
"E00004640",146,57,11,46,89,16,4,16,25,7,4,17
"E00004641",125,26,9,17,99,14,8,16,15,9,11,26
"E00004642",130,41,15,26,89,16,7,12,16,9,13,16
"E00004643",186,97,15,82,89,11,2,19,38,5,2,12
"E00004644",132,35,5,30,97,9,12,18,18,7,11,22
"E00004645",111,73,13,60,38,8,0,9,17,2,0,2
"E00004646",110,43,9,34,67,13,10,5,15,4,5,15
"E00004647",168,78,3,75,90,29,2,5,30,2,5,17
"E00004649",129,64,13,51,65,2,1,4,43,1,1,13
"E00004650",208,145,8,137,63,11,3,9,27,1,5,7
"E00004651",106,65,28,37,41,1,5,3,25,0,0,7
"E00004652",133,69,10,59,64,5,4,10,32,1,3,9
"E00004653",113,87,17,70,26,1,1,2,15,0,1,6
"E00004654",100,72,2,70,28,0,1,3,17,0,0,7
"E00004655",125,50,9,41,75,18,2,7,22,0,22,4
"E00004656",233,133,12,121,100,6,8,27,50,4,1,4
"E00004658",114,40,13,27,74,6,9,11,14,8,9,17
"E00004659",165,68,6,62,97,18,5,5,27,1,5,36
"E00004660",128,37,6,31,91,27,4,5,27,3,8,17
"E00004661",129,65,13,52,64,9,6,7,17,3,3,19
"E00004662",144,82,20,62,62,5,1,10,22,3,2,19
"E00004663",118,33,6,27,85,13,5,7,11,6,13,30
"E00004664",147,57,10,47,90,12,3,5,27,2,7,34
"E00004665",117,53,8,45,64,19,2,13,10,1,5,14
"E00004666",178,109,7,102,69,12,5,11,27,3,5,6
"E00004667",126,67,19,48,59,0,3,0,35,0,0,21
"E00004668",84,35,13,22,49,11,8,7,13,1,0,9
"E00004669",105,36,16,20,69,7,5,4,13,5,9,26
"E00004670",109,47,14,33,62,5,6,9,13,5,8,16
"E00004671",170,47,7,40,123,19,8,15,23,8,13,37
"E00004672",120,49,5,44,71,1,3,2,42,0,1,22
"E00004673",126,52,9,43,74,9,7,13,16,2,6,21
"E00004674",102,37,8,29,65,8,7,9,15,3,5,18
"E00004675",105,51,32,19,54,5,9,6,9,3,10,12
"E00004676",118,74,22,52,44,1,7,3,24,0,0,9
"E00004677",112,34,4,30,78,1,6,8,17,6,9,31
"E00004678",127,57,13,44,70,6,7,5,12,4,10,26
"E00004679",102,57,22,35,45,2,9,4,17,0,7,6
"E00004680",126,81,23,58,45,1,3,6,21,0,1,13
"E00004681",133,47,10,37,86,3,10,5,34,6,5,23
"E00004682",64,23,10,13,41,3,2,5,10,7,3,11
"E00004683",68,29,5,24,39,4,6,4,3,2,10,10
"E00004684",132,49,10,39,83,7,8,16,18,6,9,19
"E00004685",122,47,17,30,75,4,4,9,12,9,7,30
"E00004686",123,44,16,28,79,8,5,6,20,3,14,23
"E00004687",116,46,21,25,70,2,18,7,17,0,7,19
"E00004688",174,78,38,40,96,11,11,18,13,8,7,28
"E00004689",116,32,21,11,84,9,8,15,11,3,13,25
"E00004690",109,48,19,29,61,4,6,6,18,0,4,23
"E00004691",151,32,8,24,119,3,7,10,10,2,7,80
"E00004692",141,36,11,25,105,12,6,8,12,2,9,56
"E00004693",138,35,6,29,103,9,7,10,38,2,8,29
"E00004694",108,49,8,41,59,2,1,5,24,1,8,18
"E00004695",179,60,4,56,119,20,5,11,37,2,9,35
"E00004696",126,43,6,37,83,10,8,6,13,7,13,26
"E00004697",135,60,13,47,75,5,9,7,20,4,3,27
"E00004699",69,30,16,14,39,3,4,4,9,3,3,13
"E00004700",111,42,23,19,69,1,7,7,18,4,8,24
"E00004701",147,74,7,67,73,16,1,13,22,2,7,12
"E00004702",125,55,9,46,70,11,3,14,20,2,5,15
"E00004703",143,62,21,41,81,8,11,9,31,3,3,16
"E00004704",162,72,8,64,90,1,0,4,34,2,4,45
"E00004705",161,52,17,35,109,8,18,17,40,0,5,21
"E00004706",198,86,14,72,112,5,6,14,49,1,8,29
"E00004707",228,100,6,94,128,2,3,3,66,0,5,49
"E00004708",118,68,9,59,50,4,4,3,27,0,1,11
"E00004709",152,39,8,31,113,9,9,10,34,6,10,35
"E00004710",131,47,8,39,84,1,8,11,29,2,9,24
"E00004711",142,53,10,43,89,10,5,15,40,2,3,14
"E00004712",157,72,37,35,85,1,24,18,17,1,10,14
"E00004713",93,47,17,30,46,5,11,10,12,0,2,6
"E00004714",141,67,11,56,74,7,10,16,31,0,2,8
"E00004715",145,72,23,49,73,12,9,8,31,4,2,7
"E00004716",127,45,9,36,82,11,8,19,16,7,9,12
"E00004717",72,26,12,14,46,3,4,12,10,2,6,9
"E00004718",119,43,6,37,76,9,3,11,16,6,7,24
"E00004719",179,76,26,50,103,13,10,15,21,10,6,28
"E00004720",118,61,15,46,57,10,7,13,13,1,4,9
"E00004721",133,48,11,37,85,10,7,12,14,3,10,29
"E00004722",107,33,12,21,74,7,6,14,12,8,8,19
"E00004723",114,44,22,22,70,6,13,9,16,4,5,17
"E00004724",126,44,5,39,82,6,2,10,32,5,8,19
"E00004725",126,22,11,11,104,17,11,8,15,11,20,22
"E00004726",117,64,21,43,53,3,10,5,12,4,4,15
"E00004727",125,46,10,36,79,12,8,9,16,4,14,16
"E00004728",199,66,6,60,133,19,7,15,24,11,23,34
"E00004729",101,38,11,27,63,15,2,13,3,4,9,17
"E00004730",77,34,13,21,43,4,6,12,8,1,3,9
"E00004731",158,65,7,58,93,5,0,17,41,3,2,25
"E00004732",124,17,8,9,107,13,7,7,14,6,25,35
"E00004733",131,62,7,55,69,9,3,8,37,2,2,8
"E00004734",109,30,15,15,79,5,5,9,13,4,19,24
"E00004735",136,66,17,49,70,17,4,17,14,1,6,11
"E00004736",130,53,9,44,77,3,6,4,43,0,3,18
"E00004738",113,34,11,23,79,2,5,9,36,5,3,19
"E00004739",131,31,6,25,100,7,4,17,61,0,3,8
"E00004740",99,13,3,10,86,22,4,11,13,1,13,22
"E00004741",132,38,9,29,94,9,13,11,26,4,5,26
"E00004742",185,57,14,43,128,16,9,10,26,1,42,24
"E00004743",136,32,15,17,104,5,17,6,14,5,11,46
"E00004744",126,41,16,25,85,6,13,7,14,0,14,31
"E00004745",127,55,19,36,72,6,13,10,12,4,10,17
"E00004746",152,64,20,44,88,16,10,8,29,5,6,14
"E00004747",132,42,14,28,90,15,6,12,14,3,10,30
"E00004748",151,71,15,56,80,8,3,9,19,7,8,26
"E00004749",178,44,9,35,134,11,11,10,29,11,18,44
"E00004750",144,30,2,28,114,9,6,8,39,3,5,44
"E00004751",147,95,52,43,52,7,7,3,22,1,3,9
"E00004752",127,37,12,25,90,11,7,18,21,1,14,18
"E00004753",125,44,13,31,81,12,9,9,13,3,5,30
"E00004754",134,41,6,35,93,10,8,8,30,3,3,31
"E00004755",111,40,16,24,71,12,11,7,15,3,6,17
"E00004756",112,42,7,35,70,13,6,8,16,4,8,15
"E00004757",116,27,12,15,89,18,8,12,13,12,7,19
"E00004758",80,15,4,11,65,14,3,9,12,8,7,12
"E00004759",104,44,7,37,60,6,5,8,16,5,7,13
"E00004760",104,52,20,32,52,19,7,12,4,1,1,8
"E00004761",136,49,9,40,87,13,4,38,11,4,6,11
"E00004762",133,74,20,54,59,8,3,9,18,3,7,11
"E00004763",110,44,15,29,66,6,5,11,32,2,4,6
"E00004764",93,34,9,25,59,3,6,5,11,2,9,23
"E00004765",102,45,12,33,57,7,2,16,11,3,6,12
"E00004766",121,53,14,39,68,1,7,12,27,0,1,20
"E00004767",142,50,12,38,92,3,5,18,50,3,3,10
"E00004768",99,32,7,25,67,0,2,15,33,1,3,13
"E00004769",151,78,14,64,73,2,2,13,40,1,3,12
"E00004770",91,31,6,25,60,1,9,13,20,1,5,11
"E00004771",117,29,12,17,88,0,16,15,17,9,9,22
"E00004772",124,43,17,26,81,1,9,14,35,4,6,12
"E00004773",133,66,20,46,67,1,8,12,26,3,3,14
"E00004774",108,36,10,26,72,3,10,12,41,1,0,5
"E00004775",113,40,13,27,73,1,9,20,23,1,5,14
"E00004776",138,34,5,29,104,7,5,18,56,0,2,16
"E00004777",115,33,9,24,82,12,7,16,15,7,6,19
"E00004778",105,42,13,29,63,1,9,12,21,3,2,15
"E00004779",142,60,23,37,82,6,17,29,13,1,5,11
"E00004780",124,40,20,20,84,0,12,23,34,1,6,8
"E00004781",134,43,12,31,91,6,14,17,33,1,8,12
"E00004782",114,45,24,21,69,0,14,19,16,5,7,8
"E00004783",124,33,13,20,91,9,19,19,14,6,7,17
"E00004784",121,54,22,32,67,3,14,16,12,3,6,13
"E00004785",123,41,17,24,82,12,9,14,17,2,5,23
"E00004786",107,47,14,33,60,0,15,7,25,0,0,13
"E00004787",145,64,12,52,81,3,6,11,39,2,5,15
"E00004788",125,52,10,42,73,2,4,17,36,2,2,10
"E00004789",87,23,0,23,64,12,2,14,20,8,6,2
"E00004790",130,56,9,47,74,2,4,11,41,4,0,12
"E00004791",106,35,10,25,71,6,10,13,19,0,2,21
"E00004792",117,39,6,33,78,1,6,13,37,1,7,13
"E00004793",121,46,18,28,75,6,11,25,23,3,0,7
"E00004794",198,54,18,36,144,9,27,22,28,15,19,24
"E00004795",101,35,7,28,66,2,5,14,18,2,7,18
"E00004796",132,48,8,40,84,1,6,15,46,0,2,14
"E00004797",143,53,15,38,90,11,8,10,24,5,16,16
"E00004798",111,35,11,24,76,2,4,21,37,0,4,8
"E00004799",142,45,6,39,97,3,7,24,44,1,4,14
"E00004801",133,39,5,34,94,2,4,17,51,0,2,18
"E00004802",108,33,5,28,75,3,6,19,36,1,1,9
"E00004803",82,36,11,25,46,3,5,3,21,1,2,11
"E00004804",113,50,5,45,63,0,3,15,28,0,0,17
"E00004805",96,31,6,25,65,13,9,11,13,3,3,13
"E00004806",124,45,7,38,79,1,5,19,41,1,2,10
"E00004807",109,36,14,22,73,9,11,12,21,3,4,13
"E00004808",93,28,8,20,65,0,6,3,21,1,2,32
"E00004809",117,42,16,26,75,2,18,17,25,0,6,7
"E00004810",126,32,10,22,94,1,14,23,30,1,3,22
"E00004811",122,42,12,30,80,3,4,14,38,1,2,18
"E00004812",160,60,8,52,100,15,10,8,35,4,10,18
"E00004813",174,64,16,48,110,3,13,23,47,6,3,15
"E00004814",124,61,13,48,63,1,7,5,41,1,1,7
"E00004815",242,93,15,78,149,11,10,23,60,2,12,31
"E00004816",131,69,7,62,62,1,4,10,29,1,1,16
"E00004817",112,43,11,32,69,3,9,21,13,3,2,18
"E00004818",138,89,2,87,49,1,2,2,33,0,0,11
"E00004819",138,35,6,29,103,2,9,28,36,4,4,20
"E00004820",136,52,4,48,84,0,5,17,38,2,2,20
"E00004821",109,56,7,49,53,3,4,7,28,1,0,10
"E00004822",130,29,12,17,101,3,5,28,33,3,4,25
"E00004823",180,77,34,43,103,11,13,19,32,6,10,12
"E00004824",130,69,7,62,61,2,4,4,36,0,1,14
"E00004825",110,53,2,51,57,0,2,9,31,0,2,13
"E00004826",125,47,3,44,78,2,9,7,43,0,1,16
"E00004827",168,81,13,68,87,15,5,15,24,1,8,19
"E00004828",133,63,14,49,70,7,11,4,17,3,5,23
"E00004829",109,48,7,41,61,1,4,5,27,1,5,18
"E00004830",139,60,12,48,79,7,3,10,28,0,7,24
"E00004831",117,52,5,47,65,15,2,15,16,3,8,6
"E00004832",147,50,3,47,97,5,3,6,38,2,8,35
"E00004833",156,55,13,42,101,5,7,11,46,2,5,25
"E00004834",185,64,14,50,121,12,8,14,48,6,11,22
"E00004835",167,69,9,60,98,3,1,8,56,2,1,27
"E00004836",171,81,21,60,90,6,5,12,23,0,3,41
"E00004837",191,70,10,60,121,10,2,19,60,3,1,26
"E00004838",131,64,13,51,67,5,8,8,27,2,4,13
"E00004839",178,94,11,83,84,8,2,7,40,0,7,20
"E00004840",117,41,4,37,76,4,7,8,42,3,2,10
"E00004841",133,51,15,36,82,9,8,10,35,5,2,13
"E00004842",116,35,9,26,81,4,5,17,29,1,1,24
"E00004843",110,53,10,43,57,4,3,7,31,0,4,8
"E00004844",139,57,13,44,82,3,4,12,46,1,3,13
"E00004845",131,59,20,39,72,2,5,11,38,0,1,15
"E00004846",127,39,8,31,88,4,5,13,41,2,2,21
"E00004847",137,71,28,43,66,2,3,12,37,0,1,11
"E00004848",159,70,16,54,89,4,6,15,35,1,5,23
"E00004849",138,46,14,32,92,4,7,13,45,0,5,18
"E00004850",203,59,22,37,144,10,5,25,61,1,5,37
"E00004851",95,31,5,26,64,3,2,5,38,0,1,15
"E00004852",138,46,14,32,92,1,9,17,44,1,2,18
"E00004853",144,50,7,43,94,5,2,5,40,1,0,41
"E00174649",108,29,0,29,79,13,0,9,21,5,7,24
"E00174650",92,50,1,49,42,1,3,2,28,0,0,8
"E00174651",81,37,3,34,44,10,1,3,18,2,0,10
"E00174652",84,30,5,25,54,7,5,2,32,1,2,5
"E00174653",105,31,13,18,74,2,7,5,15,3,15,27
"E00174654",98,26,3,23,72,3,6,7,26,7,4,19
"E00174655",160,86,18,68,74,1,13,4,30,0,1,25
"E00174656",115,56,34,22,59,1,2,10,25,1,0,20
"E00174657",100,26,4,22,74,5,5,14,24,5,5,16
"E00174658",80,32,8,24,48,0,4,7,23,0,3,11
"E00174659",161,75,15,60,86,0,5,6,35,1,4,35
"E00174660",51,13,4,9,38,3,4,6,7,0,3,15
"E00174661",84,19,2,17,65,9,2,9,14,1,13,17
"E00174662",90,69,2,67,21,0,0,1,15,0,0,5
"E00174663",111,92,4,88,19,0,2,1,7,0,1,8
"E00174664",100,86,6,80,14,0,0,3,7,0,0,4
"E00174665",113,43,8,35,70,15,3,5,25,1,4,17
"E00174666",80,38,0,38,42,2,0,12,22,3,1,2
"E00174667",87,32,6,26,55,2,1,3,19,3,3,24
"E00174668",108,36,24,12,72,10,8,5,16,3,8,22
"E00174669",125,29,7,22,96,23,2,23,13,10,16,9
"E00174670",107,35,3,32,72,2,4,30,19,10,4,3
"E00174671",87,36,4,32,51,1,4,11,28,0,0,7
"E00174672",141,72,2,70,69,4,0,9,44,0,1,11
"E00174673",91,77,1,76,14,1,0,1,9,0,0,3
"E00174674",88,39,2,37,49,0,0,2,36,0,0,11
"E00174675",117,46,11,35,71,3,4,6,32,1,4,21
"E00174676",152,110,1,109,42,1,1,0,34,0,0,6
"E00174677",160,60,19,41,100,9,7,27,37,3,6,11
"E00174678",113,36,10,26,77,5,4,10,37,0,0,21
"E00174679",49,37,0,37,12,0,1,2,8,0,0,1
"E00174680",91,28,8,20,63,11,6,7,11,3,5,20
